abolida	abolie
abolido	aboli
abril	avril
absoluta	absolue
abstracta	abstraite
absurdo	absurde
academias	académies
académico	académique
accesible	accessible
accidental	accidentelle
accidentalmente	accidentellement
acepta	accepte
aceptar	accepter
acompañar	accompagner
actitudes	attitudes
activado	activé
activamente	activement
activos	actifs
actos	actes
acuario	aquarium
acuerdos	accords
acusaciones	accusations
adaptaciones	adaptations
administrador	administrateur
administradores	administrateurs
administrativa	administrative
administrativamente	administrativement
administrativas	administratives
admiración	admiration
adolescentes	adolescents
adquisiciones	acquisitions
aduana	douane
aduanas	douanes
aeropuertos	aéroports
afgano	afghan
africano	africain
agencias	agences
agresiva	agressive
agresivo	agressif
agricultores	agriculteurs
agrícola	agricole
albanesa	albanaise
alemanas	allemandes
alemanes	allemands
alemán	allemand
alimentada	alimentée
alimentaria	alimentaire
altamente	hautement
alterna	alterne
alternancia	alternance
alternativa	alternative
alternativas	alternatives
amenazar	menacer
americanos	américains
amigas	amies
analista	analyste
analistas	analystes
analogía	analogie
analíticos	analytiques
analógicas	analogiques
anarquistas	anarchistes
anglicano	anglican
anglosajona	anglo-saxonne
anglosajones	anglo-saxons
anglosajón	anglo-saxon
angélica	angélique
animados	animés
animal	animale
aniversario	anniversaire
antagonistas	antagonistes
antenas	antennes
antibióticos	antibiotiques
anticipada	anticipée
anticipadas	anticipées
anticuerpos	anticorps
antisemitas	antisémites
antropología	anthropologie
antropólogo	anthropologue
anual	annuel
anuales	annuels
aparentemente	apparemment
aprenden	apprennent
apropiados	appropriés
arbitraria	arbitraire
archivos	archives
armados	armés
armamentos	armements
armas	armes
aromas	arômes
arrestos	arrestations
arterial	artérielle
arterias	artères
artesanal	artisanale
artesanales	artisanales
artificialmente	artificiellement
artistas	artistes
artísticas	artistiques
asalariados	salariés
asesinos	assassins
asistentes	assistants
aspectos	aspects
astronauta	astronaute
astronómica	astronomique
astronómicas	astronomiques
atentados	attentats
atletas	athlètes
atmosféricos	atmosphériques
atributos	attributs
ausente	absent
australiano	australien
autobuses	autobus
automática	automatique
automáticamente	automatiquement
automóvil	automobile
autores	auteurs
autoridades	autorités
autorizado	autorisé
autorizados	autorisés
aventura	aventure
avión	avion
axiomas	axiomes
aéreos	aériens
bacteria	bactérie
balanza	balance
balas	balles
balcón	balcons
ballenas	baleines
balón	ballon
bancarias	bancaires
bandidos	bandits
banquero	banquier
banqueros	banquiers
barba	barbe
barones	barons
barricadas	barricades
bastiones	bastions
batalla	bataille
batallas	batailles
batallón	bataillon
batería	batterie
belgas	belges
benedictina	bénédictine
beneficiario	bénéficiaire
biblioteca	bibliothèque
billetes	billets
biodiversidad	biodiversité
biología	biologie
biológicas	biologiques
biomasa	biomasse
bizantinas	byzantines
blanca	blanche
blancos	blancs
blindado	blindée
blindados	blindés
bloquea	bloque
bloquear	bloquer
boicot	boycott
bolcheviques	bolcheviks
boletín	bulletin
bombardeado	bombardé
bombardeo	bombardement
bombardeos	bombardements
bombarderos	bombardiers
bordean	bordent
botas	bottes
botella	bouteille
botellas	bouteilles
brevemente	brièvement
brigada	brigadier
brigadas	brigades
brilla	brille
brutal	brutale
budismo	bouddhisme
bufón	bouffon
búlgara	bulgare
búlgaros	bulgares
búnker	bunker
cabina	cabine
cadáver	cadavre
calculada	calculée
calendarios	calendriers
calor	chaleur
calvario	calvaire
camaradas	camarades
campañas	campagnes
campeón	champion
canciones	chansons
candidata	candidate
candidato	candidat
candidaturas	candidatures
canonización	canonisation
cantan	chantent
cantones	cantons
cantor	chantre
cantón	canton
capillas	chapelles
capitales	capitaux
capitalismo	capitalisme
capitalista	capitaliste
capitanes	capitaines
carabineros	carabiniers
caracteriza	caractérise
caracterización	caractérisation
caracterizan	caractérisent
caracterizar	caractériser
características	caractéristiques
carbono	carbone
carbón	charbon
carga	charge
cargas	charges
carisma	charisme
carismático	charismatique
carnívoros	carnivores
carrera	carrière
cartografía	cartographie
cartuchos	cartouches
casta	caste
catalán	catalan
catastro	cadastre
catecismo	catéchisme
catedrales	cathédrales
categoría	catégorie
catorce	quatorze
catástrofe	catastrophe
catástrofes	catastrophes
cañones	canons
celular	cellulaire
cemento	ciment
censura	censure
centralizado	centralisé
centro	centre
cereales	céréales
ceremonias	cérémonies
cerezas	cerises
certificado	certificat
champán	champagne
chilena	chilienne
chileno	chilien
chinas	chinoises
chino	chinois
chipriota	chypriote
choques	chocs
ciclismo	cyclisme
ciencia	science
ciencias	sciences
científicos	scientifiques
cierta	certaine
cinturones	ceintures
cinética	cinétique
circuito	circuit
circuitos	circuits
circulación	circulation
circular	circuler
circunstancias	circonstances
clandestinamente	clandestinement
clandestinidad	clandestinité
clandestinos	clandestins
claramente	clairement
claras	claires
claros	clairs
clavos	clous
clemencia	clémence
clientela	clientèle
clima	climat
cloro	chlore
cloruro	chlorure
coalición	coalition
cocaína	cocaïne
cocodrilo	crocodile
cocodrilos	crocodiles
coeficientes	coefficients
coherente	cohérente
cohesión	cohésion
colinas	collines
colisión	collision
colombiana	colombienne
colonial	coloniale
colonialismo	colonialisme
colonización	colonisation
colonizado	colonisé
colorantes	colorants
colorido	coloré
comandante	commandant
comandantes	commandants
comando	commando
combina	combine
combinaciones	combinaisons
combustión	combustion
comentaristas	commentateurs
comercializada	commercialisée
comercializar	commercialiser
comisarios	commissaires
comisiones	commissions
comparar	comparer
comparativa	comparative
compatibilidad	compatibilité
compatriota	compatriote
compensar	compenser
competente	compétente
competiciones	compétitions
compleja	complexe
complementan	complètent
complementar	compléter
complementarias	complémentaires
complementos	compléments
completa	complète
complicaciones	complications
complicidad	complicité
componen	composent
comportamiento	comportement
comportamientos	comportements
composiciones	compositions
compositor	compositeur
compositores	compositeurs
comprender	comprendre
comprensión	compréhension
comunicaciones	communications
comunicación	communication
comunistas	communistes
comunitaria	communautaire
comunitarias	communautaires
común	commune
comúnmente	communément
concepto	concept
concesionario	concessionnaire
conciencia	conscience
conciertos	concerts
conciliación	conciliation
conciliar	concilier
concretas	concrètes
condenando	condamnant
condensación	condensation
conducta	conduite
conductividad	conductivité
conductores	conducteurs
confederación	confédération
confianza	confiance
confiere	confère
confieren	confèrent
confinamiento	confinement
confirma	confirme
confirmado	confirmé
confirmar	confirmer
confiscación	confiscation
conflicto	conflit
conflictos	conflits
confrontaciones	confrontations
confrontar	confronter
confusiones	confusions
confusión	confusion
conmemorativas	commémoratives
conquista	conquête
consagración	consécration
consecutivo	consécutive
consecutivos	consécutives
consejeros	conseillers
consejo	conseil
consenso	consensus
consentimiento	consentement
conservación	conservation
conservador	conservateur
considerables	considérables
consideraciones	considérations
considerando	considérant
consolidación	consolidation
conspiración	conspiration
constituidos	constitués
construcción	construction
consulado	consulat
consultado	consulté
consultar	consulter
consultivo	consultatif
consumen	consomment
contemporáneas	contemporaines
contenedores	conteneurs
contexto	contexte
contiene	contient
continental	continentale
continente	continent
continentes	continents
contrabando	contrebande
contracción	contraction
contradictoria	contradictoire
contrasta	contraste
contrato	contrat
contratos	contrats
controlan	contrôlent
controlar	contrôler
controles	contrôles
controvertidas	controversées
controvertido	controversé
convencional	conventionnelle
convergen	convergent
convergencia	convergence
convicción	conviction
cooperar	coopérer
cooperativas	coopératives
coordinar	coordonner
copias	copies
cordón	cordon
coreana	coréenne
corona	couronne
correcciones	corrections
corregir	corriger
corrupción	corruption
corsarios	corsaires
cortejo	cortège
corto	court
cosmopolita	cosmopolite
cosméticos	cosmétiques
coste	coût
costeros	côtiers
costumbres	coutumes
crepúsculo	crépuscule
criaturas	créatures
crimen	crime
criminales	criminels
critican	critiquent
croata	croate
croatas	croates
cualificación	qualification
cuantificación	quantification
cuantitativa	quantitative
cuartas	quarts
cubana	cubaine
cubano	cubain
cubiertos	couverts
cubrir	couvrir
cuestiones	questions
culinarias	culinaires
culpabilidad	culpabilité
cultivado	cultivé
cultivados	cultivés
cultivar	cultiver
culto	culte
cultural	culturelle
culturales	culturels
cuotas	quotas
cálculo	calcul
cálculos	calculs
cómplice	complice
cónsul	consul
cónsules	consuls
danés	danois
datados	datés
debate	débat
debates	débats
decenios	décennies
decepción	déception
decide	décide
deciden	décident
decidir	décider
decisiones	décisions
decisivo	décisif
declaración	déclaration
declarar	déclarer
decreto	décret
decretos	décrets
deducción	déduction
defensas	défenses
defensivas	défensives
definición	définition
definido	défini
definitivamente	définitivement
degustación	dégustation
deliberaciones	délibérations
delimitación	délimitation
demarcación	démarcation
democratización	démocratisation
demostraciones	démonstrations
demostración	démonstration
demócrata	démocrate
demócratas	démocrates
densamente	densément
densidad	densité
dentista	dentiste
departamento	département
dependencia	dépendance
deportación	déportation
deporte	sport
deportivos	sportifs
depresión	dépression
desastrosa	désastreuse
descalificación	disqualification
descomposición	décomposition
descripción	description
desesperadamente	désespérément
desfavorables	défavorables
desierto	désert
designaba	désignait
designación	désignation
designados	désignés
desmantelado	démantelé
destilación	distillation
destinatario	destinataire
destinos	destinations
destructivo	destructeur
destruidos	détruits
destruir	détruire
determinante	déterminant
determinar	déterminer
detractores	détracteurs
detrimento	détriment
diabetes	diabète
diagnóstico	diagnostic
diagrama	diagramme
dientes	dents
difamación	diffamation
diferencia	différence
dificultades	difficultés
difracción	diffraction
difunta	défunte
digestivo	digestif
dignatarios	dignitaires
dimensión	dimension
dinamita	dynamite
dinosaurios	dinosaures
diplomacia	diplomatie
diplomática	diplomatique
diputación	députation
dirección	direction
directa	directe
directivas	directives
directo	direct
director	directeur
directores	directeurs
dirigentes	dirigeants
disciplinario	disciplinaire
disciplinas	disciplines
discordia	discorde
discreto	discret
discriminación	discrimination
disidencia	dissidence
disminución	diminution
disolución	dissolution
dispersión	dispersion
disponibilidad	disponibilité
dispositivos	dispositifs
disputada	disputée
disputan	disputent
distancia	distance
distribución	distribution
distribuida	distribué
distribuidor	distributeur
distribuidores	distributeurs
distribuir	distribuer
diversificada	diversifiée
divide	divise
divina	divine
divinas	divines
divisas	devises
divisiones	divisions
divorciado	divorcé
divorcio	divorce
diálogo	dialogue
doble	double
doctorado	doctorat
documental	documentaire
documento	document
dolor	douleur
domicilio	domicile
dominación	domination
dominan	dominent
domésticos	domestiques
donantes	donateurs
dormido	endormi
dotar	doter
dramáticas	dramatiques
dunas	dunes
dólar	dollar
economistas	économistes
educativos	éducatifs
eficaces	efficaces
ejecuciones	exécutions
ejecutiva	exécutive
ejemplo	exemple
ejercicio	exercice
elecciones	élections
electromagnética	électromagnétique
elegante	élégante
elementos	éléments
emergentes	émergents
eminente	éminent
empleadores	employeurs
encarna	incarne
encarnar	incarner
endémicas	endémiques
energéticas	énergétiques
enriquecer	enrichir
enriquecido	enrichi
ensalada	salade
enteras	entières
enteros	entiers
enterradas	enterrées
enviados	envoyés
episodio	épisode
episodios	épisodes
equilibrada	équilibrée
equilibrado	équilibré
equilibrio	équilibre
equipar	équiper
errante	errant
errores	erreurs
erupciones	éruptions
escandinava	scandinave
esclavos	esclaves
escolares	scolaires
escolarización	scolarisation
escrito	écrit
escritos	écrits
esculturas	sculptures
escáner	scanner
eslavas	slaves
espaciales	spatiales
espacios	espaces
española	espagnole
especialista	spécialiste
especialización	spécialisation
especies	espèces
especificidad	spécificité
espectacular	spectaculaire
espectadores	spectateurs
espectro	spectre
especulaciones	spéculations
esperma	sperme
espiral	spirale
espirituales	spirituels
estabilidad	stabilité
estabilizar	stabiliser
estacionamiento	stationnement
estacionario	stationnaire
estatua	statue
estatuas	statues
estatutos	statuts
este-oeste	est-ouest
estimaciones	estimations
estival	estivale
estrategias	stratégies
estratégicas	stratégiques
estrictamente	strictement
estrictas	strictes
estricto	strict
estructura	structure
estructuración	structuration
estructurado	structuré
estructuras	structures
estrés	stress
estudiante	étudiant
estudiantes	étudiants
estéril	stérile
europeas	européennes
evaluaciones	évaluations
exactamente	exactement
excepcionales	exceptionnelles
excepciones	exceptions
excesos	excès
excluida	exclue
exigencias	exigences
experto	expert
explicaciones	explications
explora	explore
explosiva	explosive
explosivos	explosifs
explotados	exploités
explotan	exploitent
explícita	explicite
explícitamente	explicitement
explícitas	explicites
exponencial	exponentielle
exportaciones	exportations
expresamente	expressément
expulsados	expulsés
extracto	extrait
extractos	extraits
extranjeros	étrangers
extraordinarias	extraordinaires
extremas	extrêmes
fabricación	fabrication
fabricante	fabricant
facciones	factions
facción	faction
facial	faciale
facilitar	faciliter
factores	facteurs
familia	famille
famosas	fameuses
fantasma	fantôme
fascinación	fascination
fascinado	fasciné
fascismo	fascisme
fascista	fasciste
fatal	fatale
fauna	faune
favores	faveurs
favorito	favori
federaciones	fédérations
federal	fédérale
federalista	fédéraliste
federalistas	fédéralistes
femeninas	féminines
feminismo	féminisme
feminista	féministe
fermentación	fermentation
ferroviarias	ferroviaires
fertilidad	fertilité
festín	festin
fiabilidad	fiabilité
fichas	fiches
ficheros	fichiers
figurado	figuré
filipinas	philippines
filma	filmé
filtros	filtres
finalistas	finalistes
financia	finance
financiada	financée
financiados	financés
financieramente	financièrement
financiero	financier
financieros	financiers
finanzas	finances
finlandesa	finlandaise
finlandeses	finlandais
flamencas	flamandes
flanco	flanc
flanqueada	flanquée
flora	flore
flores	fleurs
flotas	flottes
flotilla	flottille
fluctuaciones	fluctuations
fluidos	fluides
formación	formation
formador	formateur
formalmente	formellement
formas	formes
formatos	formats
fortificado	fortifié
fortificados	fortifiés
fosas	fosses
fotos	photos
fragata	frégate
fragatas	frégates
francos	francs
francés	français
franquista	franquiste
fraternidad	fraternité
frenada	freinage
frenos	freins
frontera	frontière
fronteras	frontières
frustración	frustration
fruta	fruits
frutales	fruitiers
fuerte	forte
funcionalidad	fonctionnalité
funcionamiento	fonctionnement
funcionar	fonctionner
funcionario	fonctionnaire
fundamentales	fondamentaux
fusiles	fusils
fusionado	fusionné
fusiones	fusions
fusión	fusion
futuros	futurs
fórmula	formule
fórmulas	formules
fósil	fossile
galerías	galeries
galope	galop
ganar	gagner
garantiza	garantit
generalista	généraliste
genios	génies
geométricas	géométriques
georgiano	géorgien
gesto	geste
gestor	gestionnaire
gestores	gestionnaires
gestos	gestes
gigantes	géants
glaciares	glaciers
gloria	gloire
glucosa	glucose
granero	grenier
grasa	graisse
gratuitamente	gratuitement
grial	graal
guantes	gants
guardián	gardien
guerra	guerre
gueto	ghetto
guiada	guidée
guiado	guidé
guiar	guider
guillotina	guillotine
habitadas	habitées
habitado	habité
hachas	haches
hectárea	hectare
helicópteros	hélicoptères
herbívoros	herbivores
hereditarias	héréditaires
hindúes	hindous
historias	histoires
históricamente	historiquement
históricas	historiques
hombres	hommes
homogénea	homogène
homólogo	homologue
honorario	honoraire
honorarios	honoraires
hormonas	hormones
hospitalaria	hospitaliers
humanista	humaniste
humanistas	humanistes
hábitat	habitats
héroe	héros
húngaro	hongrois
ibérica	ibérique
idealmente	idéalement
identidad	identité
identidades	identités
identificado	identifié
ideologías	idéologies
ignorado	ignoré
ilegalmente	illégalement
ilustra	illustre
ilustres	illustres
imperativo	impératif
implicaciones	implications
implícita	implicite
impopular	impopulaire
importadas	importées
importante	important
impresa	imprimée
inaugurada	inaugurée
incierto	incertain
incompleto	incomplet
incursiones	incursions
indefinidamente	indéfiniment
indicaciones	indications
indicador	indicateur
indicadores	indicateurs
indios	indiens
indirectos	indirects
individualmente	individuellement
industriales	industriels
industrias	industries
indígenas	indigènes
ineficaz	inefficace
inevitable	inévitable
infecciones	infections
infernal	infernale
influencia	influence
influencias	influences
influyentes	influents
informados	informés
informal	informelle
infraestructuras	infrastructures
ingenieros	ingénieurs
ingredientes	ingrédients
inmediatamente	immédiatement
inmobiliaria	immobilière
inmortales	immortels
inmunitario	immunitaire
innovadoras	innovantes
inocentes	innocents
insectos	insectes
inspirada	inspirée
instalaciones	installations
instalados	installés
instancias	instances
instantáneamente	instantanément
institucional	institutionnelle
institucionales	institutionnelles
instrumento	instrument
insular	insulaire
insulares	insulaires
intacto	intact
integrante	intégrante
inteligente	intelligente
intenciones	intentions
interactiva	interactive
intermediarios	intermédiaires
internas	internes
interpretado	interprété
interrumpido	interrompue
intrigas	intrigues
intérprete	interprète
intérpretes	interprètes
invenciones	inventions
invención	invention
inventada	inventée
inventarios	inventaires
inventores	inventeurs
invitación	invitation
invitados	invités
iraní	iranien
irlandesa	irlandaise
irlandesas	irlandaises
islamistas	islamistes
isótopos	isotopes
italianas	italiennes
italiano	italien
jamón	jambon
japonés	japonais
jungla	jungle
jurados	jurés
jurisdicciones	juridictions
jurisprudencia	jurisprudence
jurídicamente	juridiquement
justificar	justifier
jóvenes	jeunes
kilómetro	kilomètre
laboratorios	laboratoires
lagunas	lacunes
lanzamiento	lancement
lanzamientos	lancements
latín	latin
laureles	lauriers
lectores	lecteurs
legalmente	légalement
legiones	légions
legislaciones	législations
legislador	législateur
legislativa	législative
legislativo	législatif
legislativos	législatifs
legitimidad	légitimité
legítimos	légitimes
lenguas	langues
lesbiana	lesbienne
lesbianas	lesbiennes
libaneses	libanais
liberalización	libéralisation
libras	livres
libreros	libraires
licencia	licence
ligas	ligues
limitados	limités
lineales	linéaires
lingüista	linguiste
lista	liste
literalmente	littéralement
literatura	littérature
lituano	lituanien
localización	localisation
localizadas	localisées
localizados	localisés
localmente	localement
locomotora	locomotive
locomotoras	locomotives
logísticas	logistiques
longitudes	longueurs
límite	limite
límites	limites
líneas	lignes
líquida	liquide
líquidos	liquides
macedonio	macédonien
madre	mère
madres	mères
maduración	maturation
magnético	magnétique
magnéticos	magnétiques
mandatos	mandats
manifestaciones	manifestations
manipular	manipuler
manual	manuel
maquillaje	maquillage
maratón	marathon
marcial	martiale
marino	marin
marxismo	marxisme
marxista	marxiste
marítima	maritime
marítimas	maritimes
masacre	massacre
masacres	massacres
masculina	masculine
masiva	massive
materialismo	matérialisme
maternidad	maternité
mausoleo	mausolée
mayoritarios	majoritaires
meandros	méandres
mediación	médiation
medicamento	médicament
medicamentos	médicaments
medieval	médiévale
mediterránea	méditerranéenne
mediterráneas	méditerranéennes
mediterráneos	méditerranéens
membrana	membrane
mensuales	mensuelles
mentalidad	mentalité
menús	menus
metalurgia	métallurgie
metamorfosis	métamorphose
metros	mètres
metrópoli	métropole
metrópolis	métropoles
miembros	membres
migratoria	migratoire
migratorios	migratoires
milicia	milice
militancia	militantisme
militante	militant
militares	militaires
millonario	millionnaire
millones	millions
millón	million
minas	mines
minimalista	minimaliste
ministerios	ministères
ministros	ministres
minoritaria	minoritaire
minoritarias	minoritaires
minoría	minorité
minuto	minute
minúsculas	minuscules
miserables	misérables
misil	missile
misioneros	missionnaires
mixta	mixte
mixtas	mixtes
mobiliario	mobilier
modalidades	modalités
modelos	modèles
moderna	moderne
modernidad	modernité
modernizar	moderniser
modesta	modeste
modificaciones	modifications
modificación	modification
modificada	modifiée
modificadas	modifiées
moleculares	moléculaires
molécula	molécule
moléculas	molécules
monetaria	monétaire
monjes	moines
monopolio	monopole
monstruo	monstre
moralidad	moralité
moralmente	moralement
mortalmente	mortellement
mortero	mortier
motor	moteur
motores	moteurs
motorización	motorisation
movimiento	mouvement
muebles	meubles
mueren	meurent
muertos	morts
multiplica	multiplie
multiplicación	multiplication
multiplican	multiplient
multiplicidad	multiplicité
mundos	mondes
museo	musée
museos	musées
musulmán	musulman
mutuas	mutuelles
márgenes	marges
mártir	martyr
máster	masters
méritos	mérites
mínimas	minimales
módulos	modules
móviles	mobiles
naciente	naissante
nacional	national
nacionales	nationales
nacionalidades	nationalités
nacionalismo	nationalisme
nacionalista	nationaliste
nacionalistas	nationalistes
nacionalización	nationalisation
narración	narration
narrador	narrateur
naturalista	naturaliste
navegable	navigable
navegación	navigation
navegante	navigateur
nazismo	nazisme
necesarias	nécessaires
neerlandés	néerlandais
negativo	négatif
negativos	négatifs
negligencia	négligence
nigeriano	nigérian
nitrato	nitrate
nitratos	nitrates
nivel	niveau
noción	notion
nocturna	nocturne
nomenclatura	nomenclature
noreste	nord-est
normalización	normalisation
noroeste	nord-ouest
norte-sur	nord-sud
nostalgia	nostalgie
notario	notaire
notarios	notaires
nucleares	nucléaires
numerados	numérotés
nutrición	nutrition
néctar	nectar
nómadas	nomades
oblicuo	oblique
obligaciones	obligations
obligatoria	obligatoire
obsoleta	obsolète
obtenidos	obtenus
occidentales	occidentaux
ocular	oculaire
ocupantes	occupants
oficialmente	officiellement
oficios	offices
operaciones	opérations
organizadas	organisées
organizado	organisé
organizador	organisateur
organizados	organisés
oriental	orientale
ortodoxa	orthodoxe
ortodoxas	orthodoxes
orígenes	origines
paciencia	patience
pacientes	patients
pacto	pacte
pakistaní	pakistanais
palacios	palais
palma	palme
panes	pains
paquete	paquet
paquetes	paquets
paradigma	paradigme
paradójicamente	paradoxalement
paralelas	parallèles
paralelo	parallèle
parcialmente	partiellement
pares	pairs
pariente	parent
parisina	parisienne
parlamentarios	parlementaires
parlamento	parlement
participación	participation
participantes	participants
participar	participer
partición	partition
particular	particulier
partidos	partis
parálisis	paralysie
parámetro	paramètre
parásitos	parasites
pasajeros	passagers
pasiva	passive
pasivo	passif
paternidad	paternité
patria	patrie
patriota	patriote
patriotas	patriotes
patriotismo	patriotisme
patronal	patronat
patrulla	patrouille
pausa	pause
peatones	piétons
pedagogía	pédagogie
penal	pénale
penas	peines
pensaban	pensaient
peores	pires
percepción	perception
perder	perdre
peregrinos	pèlerins
perfil	profil
perfume	parfum
permanentes	permanents
permite	permet
permitir	permettre
permitirá	permettra
permitirán	permettront
permitía	permettait
persecuciones	persécutions
personaje	personnage
personajes	personnages
personal	personnel
personales	personnelles
personalidad	personnalité
personalmente	personnellement
perspectiva	perspective
persuadir	persuader
perturbación	perturbation
pesticidas	pesticides
petróleo	pétrole
pianista	pianiste
piedra	pierre
pilar	pilier
pilares	piliers
pilas	piles
pilotos	pilotes
pintor	peintre
piratería	piraterie
pirámide	pyramide
pirámides	pyramides
piscina	piscine
pistas	pistes
planeta	planète
planificación	planification
plantaciones	plantations
plantación	plantation
plantado	planté
plantados	plantés
plataforma	plate-forme
plutonio	plutonium
poetas	poètes
polacos	polonais
polar	polaires
polen	pollen
policial	policière
popularizado	popularisé
portaaviones	porte-avions
portuguesa	portugaise
portuguesas	portugaises
portugueses	portugais
portátiles	portables
posibilidad	possibilité
posibilidades	possibilités
posible	possible
posiciones	positions
positivas	positives
positivo	positif
postales	postaux
potasio	potassium
potencial	potentiel
practicar	pratiquer
precauciones	précautions
precaución	précaution
precisamente	précisément
precisas	précises
precursor	précurseur
precursores	précurseurs
predicador	prédicateur
preferencia	préférence
preferible	préférable
prefieren	préfèrent
preludio	prélude
prematura	prématurée
prepara	prépare
preparación	préparation
preparatorias	préparatoires
presencia	présence
presentaciones	présentations
preservar	préserver
presidenciales	présidentielles
presidenta	présidente
prestigiosa	prestigieuse
prestigioso	prestigieux
pretensiones	prétentions
pretexto	prétexte
preventiva	préventive
preámbulo	préambule
primarias	primaires
primario	primaire
primeros	premiers
primitivas	primitives
princesas	princesses
principios	principes
prioridad	priorité
prioridades	priorités
prisionero	prisonnier
prisión	prison
privado	privé
privatización	privatisation
privilegiado	privilégié
privilegiados	privilégiés
privilegio	privilège
problema	problème
procesión	procession
proclamación	proclamation
producciones	productions
productivo	productif
producto	produit
productor	producteur
productos	produits
profesional	professionnelle
profesionalidad	professionnalisme
profesiones	professions
profesión	profession
profundamente	profondément
programa	programme
programada	programmée
programas	programmes
progresista	progressiste
progresiva	progressive
progresivamente	progressivement
progresivo	progressif
proliferación	prolifération
prolongar	prolonger
prometedores	prometteurs
promociones	promotions
promoción	promotion
propagación	propagation
propietario	propriétaire
propietarios	propriétaires
propone	propose
proponer	proposer
proporcional	proportionnelle
proporciones	proportions
prospección	prospection
prostituta	prostituée
protección	protection
protectorado	protectorat
protege	protège
proteger	protéger
protegidos	protégés
protestar	protester
protocolo	protocole
protocolos	protocoles
prototipo	prototype
prototipos	prototypes
provincias	provinces
provisionales	provisoires
provisionalmente	provisoirement
proximidad	proximité
proyección	projection
proyecto	projet
proyectos	projets
psicoterapia	psychothérapie
publicación	publication
publicado	publié
publicando	publiant
publicar	publier
publicitario	publicitaire
puertos	ports
pulmonar	pulmonaire
puramente	purement
puras	pures
pureza	pureté
purgas	purges
purificación	purification
públicamente	publiquement
público	public
públicos	publics
quilla	quille
quince	quinze
rabinos	rabbins
racial	raciale
racista	raciste
racistas	racistes
radiactividad	radioactivité
radiactivos	radioactifs
radicales	radicaux
radiodifusión	radiodiffusion
raras	rares
ratificación	ratification
ratificado	ratifié
razones	raisons
raíces	racines
reactivos	réactifs
reactor	réacteur
reactores	réacteurs
realista	réaliste
rebeldes	rebelles
reciclado	recyclage
reciente	récente
reclutamiento	recrutement
reclutas	recrues
recomendaciones	recommandations
recomendado	recommandé
recompensado	récompensé
reconstruir	reconstruire
reconversión	reconversion
reconvertido	reconverti
recurrentes	récurrents
redactor	rédacteur
redonda	ronde
redondas	rondes
reestructuración	restructuration
referencias	références
refleja	reflète
reflejan	reflètent
reflexión	réflexion
reforzando	renforçant
refugia	réfugie
refutación	réfutation
regente	régente
regimientos	régiments
regional	régionale
regionales	régionales
regiones	régions
registros	registres
región	région
reglamentarias	réglementaires
reglamentario	réglementaire
reglamento	règlement
reglamentos	règlements
regresión	régression
rehabilitado	réhabilité
reivindicaciones	revendications
relaciones	relations
relativamente	relativement
religiosas	religieuses
religioso	religieux
remolques	remorques
remonta	remonte
remuneración	rémunération
renovables	renouvelables
renovar	renouveler
renunciar	renoncer
reorganizar	réorganiser
reparaciones	réparations
reparar	réparer
reparto	répartition
repertorio	répertoire
repertorios	répertoires
representaban	représentaient
representación	représentation
representadas	représentées
representante	représentant
representativos	représentatifs
represión	répression
reprimir	réprimer
republicanos	républicains
reputación	réputation
resentimiento	ressentiment
reservas	réserves
residentes	résidents
residir	résider
resistencia	résistance
resolución	résolution
respetuoso	respectueux
respirar	respirer
responde	répond
responder	répondre
responsabilidad	responsabilité
restricciones	restrictions
resultado	résultat
retirada	retrait
retirar	retirer
retrasos	retards
reunificación	réunification
reverendo	révérend
reversible	réversible
revolucionarias	révolutionnaires
revoluciones	révolutions
revolución	révolution
ricos	riches
rigidez	rigidité
rigor	rigueur
rigurosa	rigoureuse
ritos	rites
rituales	rituels
rivalidades	rivalités
riñones	reins
románticos	romantiques
ruina	ruine
ruinas	ruines
rumana	roumaine
rumano	roumain
rumanos	roumains
rumor	rumeur
rusas	russes
rutina	routine
rápida	rapide
rígida	rigide
sabotaje	sabotage
sacrificar	sacrifier
sacrificios	sacrifices
salario	salaire
salas	salles
salvajes	sauvages
sanción	sanction
sanguíneo	sanguin
sanitarias	sanitaires
santos	saints
santuario	sanctuaire
sargento	sergent
saturación	saturation
satélite	satellite
satélites	satellites
secciones	sections
secesión	sécession
secretaría	secrétariat
secreto	secret
sector	secteur
sectores	secteurs
secundaria	secondaire
secundarias	secondaires
segmento	segment
selecciones	sélections
selectivo	sélectif
seminarios	séminaires
sensibilización	sensibilisation
separación	séparation
septentrional	septentrionale
septiembre	septembre
serbia	serbe
serpiente	serpent
servidumbre	servitude
sesiones	session
siderurgia	sidérurgie
significa	signifie
silenciosa	silencieuse
simplicidad	simplicité
simplificación	simplification
simplificado	simplifiée
simposio	symposium
simulaciones	simulations
simulación	simulation
simultánea	simultanée
simultáneo	simultané
sinagoga	synagogue
sincronización	synchronisation
sindical	syndicale
sindicato	syndicat
sindicatos	syndicats
sionismo	sionisme
sionista	sioniste
sitios	sites
situados	situés
soberanos	souverains
social	sociale
socialdemócrata	social-démocrate
socialdemócratas	sociaux-démocrates
socialmente	socialement
sociólogos	sociologues
sodio	sodium
soldados	soldats
solitaria	solitaire
solución	solution
soviéticas	soviétiques
subdivisiones	subdivisions
submarino	sous-marin
subordinados	subordonnés
subsistencia	subsistance
subvenciones	subventions
sucesor	successeur
sucesores	successeurs
sucursal	succursale
sudoeste	sud-ouest
sufragio	suffrage
suicidio	suicide
suicidó	suicidé
supermercado	supermarché
supermercados	supermarchés
superviviente	survivant
supervivientes	survivants
suplente	suppléant
suplentes	suppléants
suprimir	supprimer
surrealista	surréaliste
suscripción	souscription
suspender	suspendre
suspendido	suspendu
sílice	silice
símbolos	symboles
tabaco	tabac
tableta	tablette
tailandés	thaïlandais
talentos	talents
tallas	tailles
talón	talon
tatuaje	tatouage
tecnológicas	technologiques
telecomunicaciones	télécommunications
televisiones	télévisions
templo	temple
temporales	temporaires
temporalmente	temporairement
tensiones	tensions
tentáculos	tentacules
terminales	terminaux
terminología	terminologie
territorial	territoriale
territorio	territoire
terrorismo	terrorisme
terrorista	terroriste
tesoros	trésors
textil	textile
texto	texte
textos	textes
tibetana	tibétaine
tirano	tyran
titulares	titulaires
tomate	tomates
torsión	torsion
torturado	torturé
tractor	tracteur
tradicionalmente	traditionnellement
tradiciones	traditions
traductor	traducteur
tragedia	tragédie
trampolín	tremplin
transacciones	transactions
transatlántico	transatlantique
transcripción	transcription
transferencias	transferts
transferido	transféré
transferir	transférer
transformación	transformation
transformados	transformés
transforman	transforment
transición	transition
transparencia	transparence
transportadas	transportées
transportados	transportés
transportistas	transporteurs
transposición	transposition
transversal	transversale
trauma	traumatisme
travesías	traversées
trece	treize
tribuna	tribune
tribunales	tribunaux
trilogía	trilogie
tristeza	tristesse
tropas	troupes
tropical	tropicale
tránsito	transit
tumores	tumeurs
turba	tourbe
turbinas	turbines
tándem	tandem
túnel	tunnel
unitaria	unitaire
universidad	université
universitarios	universitaires
unánime	unanime
urbana	urbaine
urbanas	urbaines
urbano	urbain
urgencias	urgences
utilizable	utilisable
vacunas	vaccins
validación	validation
validar	valider
valle	vallée
valores	valeurs
valorización	valorisation
vapor	vapeur
variados	variés
vector	vecteur
vegetales	végétales
vendedor	vendeur
vendedores	vendeurs
vender	vendre
ventas	ventes
verbal	verbale
verbo	verbe
verificación	vérification
versiones	versions
versión	version
verticales	verticaux
verticalmente	verticalement
vibraciones	vibrations
victoria	victoire
victorias	victoires
vinagre	vinaigre
violenta	violente
violentamente	violemment
viral	virale
virtuales	virtuels
virtudes	vertus
virtuosismo	virtuosité
visitante	visiteur
visitantes	visiteurs
visitas	visites
viven	vivent
vivero	vivier
volumen	volume
voluntaria	volontaire
voluntariamente	volontairement
volúmenes	volumes
votar	voter
vulnerable	vulnérable
víctima	victime
víveres	vivres
ácidos	acides
álbumes	albums
árbitros	arbitres
áridas	arides
átomos	atomes
órgano	organe
útiles	utiles
poblaciones	populations
gramos	grammes
privilegios	privilèges
asociativa	associative
estrategia	stratégie
brasileña	brésilien
jardín	jardin
vocabulario	vocabulaire
floración	floraison
pintura	peinture
accidente	accident
vectores	vecteurs
gastronómica	gastronomique
porcentaje	pourcentage
fortunas	fortunes
diferencias	différences
lectura	lecture
atmosférica	atmosphérique
condecoraciones	décorations
diccionario	dictionnaire
excesiva	excessive
naturales	naturelles
paraíso	paradis
adversario	adversaire
arquitecto	architecte
florines	florins
rocas	rochers
deliberadamente	délibérément
motivaciones	motivations
cantantes	chanteurs
negociaciones	négociations
limitada	limitée
festivales	festivals
espectador	spectateur
defensores	défenseurs
discurso	discours
reacciones	réactions
granos	grains
bacterias	bactéries
vainilla	vanille
asistente	assistant
violencia	violence
constelación	constellation
contextos	contextes
augusto	auguste
caravanas	caravanes
contenido	contenu
bloqueada	bloquée
calendario	calendrier
planificada	planifiée
marionetas	marionnettes
enemigos	ennemis
naval	navale
canadiense	canadien
harina	farine
montaña	montagne
abstracción	abstraction
violentas	violentes
operativos	opérationnels
incapaz	incapable
apocalipsis	apocalypse
coreano	coréen
descritas	décrites
burguesa	bourgeoise
evangélicas	évangéliques
nubes	nuages
cabinas	cabines
audiovisual	audiovisuel
directas	directes
astrónomo	astronome
pionero	pionnier
culturas	cultures
musulmana	musulmane
contemporánea	contemporaine
arquitecturas	architectures
litros	litres
profunda	profonde
récord	record
dinamismo	dynamisme
vivir	vivre
sheriff	shérif
vitaminas	vitamines
deportiva	sportive
protecciones	protections
restricción	restriction
confrontación	confrontation
filial	filiale
ascensores	ascenseurs
inspirado	inspiré
armenio	arménien
reproducción	reproduction
sociólogo	sociologue
federales	fédérales
indonesio	indonésien
colina	colline
credibilidad	crédibilité
fractura	fracture
inventor	inventeur
revólver	revolver
asociaciones	associations
reducción	réduction
perdido	perdu
financiar	financer
urbanos	urbains
aceptado	accepté
urnas	urnes
miembro	membre
funcionarios	fonctionnaires
dependen	dépendent
californiano	californien
leucemia	leucémie
esenciales	essentiels
ingeniero	ingénieur
pierden	perdent
motivación	motivation
homenajes	hommages
tornado	tornade
musulmanes	musulmans
estratégica	stratégique
bienes	biens
proclamada	proclamée
criterios	critères
volante	volant
desbloquear	débloquer
caldero	chaudron
oficial	officielle
jesuita	jésuite
corrección	correction
consejos	conseils
precisión	précision
ironía	ironie
colaboradores	collaborateurs
visita	visite
mensajero	messager
cómplices	complices
franciscano	franciscain
artesanos	artisans
cerebrales	cérébrales
socialistas	socialistes
animales	animaux
modulación	modulation
italiana	italienne
realistas	réalistes
prusiano	prussien
cubanos	cubains
soportar	supporter
industrial	industrielle
conquistada	conquise
juristas	juristes
solidaria	solidaire
heterogénea	hétérogène
negociación	négociation
fascistas	fascistes
franco	franc
órbita	orbite
identificada	identifiée
valor	valeur
neumonía	pneumonie
perturbaciones	perturbations
restablecimiento	rétablissement
gastronomía	gastronomie
presiones	pressions
estética	esthétique
reconciliación	réconciliation
conquistado	conquis
confirmada	confirmée
auspicios	auspices
traficantes	trafiquants
complemento	complément
sustancias	substances
estéticas	esthétiques
pensiones	pensions
diversidad	diversité
migración	migration
confirmación	confirmation
controladas	contrôlées
jesuitas	jésuites
transportada	transportée
doctrinas	doctrines
neutral	neutre
estables	stables
pinturas	peintures
valer	valoir
vengarse	venger
conclusiones	conclusions
prisioneros	prisonniers
convencidos	convaincus
reconstrucción	reconstruction
refugiados	réfugiés
intelectuales	intellectuels
actores	acteurs
garantía	garantie
funciona	fonctionne
prestigio	prestige
caracteres	caractères
emisiones	émissions
concesiones	concessions
consulares	consulaires
reportajes	reportages
corta	courte
comercialización	commercialisation
transitorio	transitoire
bibliotecas	bibliothèques
cifras	chiffres
manifestantes	manifestants
espiritualidad	spiritualité
imperial	impériale
exiliados	exilés
prensa	presse
tradicionales	traditionnels
mercante	marchande
defensa	défense
esclava	esclave
carrocería	carrosserie
bárbara	barbare
fantásticas	fantastiques
fibra	fibres
coronel	colonel
revisión	révision
servicios	services
revestimientos	revêtements
integrar	intégrer
vulnerables	vulnérables
considerados	considérés
convencionales	conventionnelles
multiplicar	multiplier
espontánea	spontanée
distinción	distinction
solemne	solennelle
bucle	boucle
gripe	grippe
romano	romain
monstruos	monstres
acciones	actions
presentación	présentation
fundaciones	fondations
tuberculosis	tuberculose
restaurante	restaurant
salvaje	sauvage
polivalente	polyvalente
paradoja	paradoxe
óperas	opéras
cadáveres	cadavres
masivos	massifs
portuaria	portuaire
península	péninsule
motivado	motivé
rivalidad	rivalité
mortalidad	mortalité
aventuras	aventures
diáspora	diaspora
tripartita	tripartite
obstáculos	obstacles
serbias	serbes
teatrales	théâtrales
identificando	identifiant
agencia	agence
representativas	représentatives
celulosa	cellulose
cuaternario	quaternaire
disposiciones	dispositions
conferencia	conférence
electromagnéticos	électromagnétiques
producir	produire
instalada	installée
explosiones	explosions
convencer	convaincre
decorativo	décoratif
documentos	documents
turismo	tourisme
incierta	incertaine
obligatorias	obligatoires
recesión	récession
lentitud	lenteur
desmembramiento	démembrement
piedras	pierres
contabilidad	comptabilité
continentales	continentaux
viticultura	viticulture
probablemente	probablement
íntima	intime
catálogos	catalogues
eslóganes	slogans
tiempo	temps
eslava	slave
desiertos	déserts
sudeste	sud-est
degradación	dégradation
suspensión	suspension
visión	vision
familias	familles
militar	militaire
módulo	module
coronas	couronnes
cliente	client
ideal	idéal
representado	représenté
sucesivos	successifs
deportivas	sportives
profundas	profondes
caverna	caverne
particularidades	particularités
lengua	langue
reparación	réparation
concertación	concertation
conmemoración	commémoration
terror	terreur
vocaciones	vocations
modernización	modernisation
tortugas	tortues
litigios	litiges
indias	indiennes
manuscrita	manuscrite
continuidad	continuité
patrullas	patrouilles
minorías	minorités
africanos	africains
doctrina	doctrine
correlación	corrélation
palestino	palestinien
efectos	effets
frágil	fragile
diálogos	dialogues
funeral	funérailles
multidisciplinar	pluridisciplinaire
permiten	permettent
civilizaciones	civilisations
imaginaria	imaginaire
horizontales	horizontaux
inéditos	inédits
redactores	rédacteurs
molde	moule
promotor	promoteur
fisión	fission
defensiva	défensive
coloquio	colloque
grandeza	grandeur
brutalmente	brutalement
soberano	souverain
sirenas	sirènes
juzgar	juger
problemáticas	problématiques
crisis	crise
reflexiones	réflexions
presidir	présider
contingentes	contingents
prevenir	prévenir
genéticamente	génétiquement
reforma	réforme
psicología	psychologie
africanas	africaines
canadienses	canadiens
intrínseca	intrinsèque
petroleros	pétroliers
chocolate	chocolat
múltiples	multiples
ofensiva	offensive
ruedas	roues
aspiraciones	aspirations
mecanismo	mécanisme
canalización	canalisation
internacional	internationale
identificadas	identifiées
color	couleur
brasileños	brésiliens
instrucciones	instructions
simplificar	simplifier
contingente	contingent
humanas	humaines
disposición	disposition
europeos	européens
ceremonia	cérémonie
concentrado	concentré
definidos	définis
indirectamente	indirectement
angular	angulaire
municipios	municipalités
modernizado	modernisé
perspectivas	perspectives
diciembre	décembre
intervalos	intervalles
liberalismo	libéralisme
liberación	libération
preliminares	préliminaires
soldado	soldat
difícilmente	difficilement
talibanes	talibans
discípulos	disciples
licencias	licences
simplemente	simplement
sociológicas	sociologiques
símbolo	symbole
monasterio	monastère
matriz	matrice
ritual	rituel
paracaidistas	parachutistes
defender	défendre
ejemplar	exemplaire
favorecer	favoriser
coordinador	coordinateur
dilema	dilemme
conclusión	conclusion
obligatoriamente	obligatoirement
escándalos	scandales
carguero	cargo
reclutar	recruter
obstáculo	obstacle
estable	stable
morirá	mourra
situación	situation
popularidad	popularité
genoma	génome
emboscada	embuscade
mutuamente	mutuellement
prostitutas	prostituées
lotería	loterie
conferencias	conférences
transportado	transporté
instrumentos	instruments
portuarias	portuaires
federalismo	fédéralisme
desacuerdos	désaccords
violación	violation
profesor	professeur
dispersar	disperser
batallones	bataillons
sedimentos	sédiments
natalidad	natalité
dimisión	démission
emociones	émotions
respectivas	respectives
alianzas	alliances
fumar	fumer
conversiones	conversions
inventario	inventaire
convoyes	convois
importados	importés
estratega	stratège
insurgentes	insurgés
hormigas	fourmis
partituras	partitions
dólares	dollars
boxeador	boxeur
definitiva	définitive
cáncer	cancer
chantaje	chantage
frases	phrases
copiar	copier
eficaz	efficace
cultivadas	cultivées
violento	violent
petroleras	pétrolières
soviético	soviétique
repliegue	repli
joyas	joyaux
tumor	tumeur
conservadores	conservateurs
signos	signes
discretos	discrets
transferencia	transfert
congreso	congrès
refugiarse	réfugier
confiscadas	confisqués
perdidos	perdus
clandestina	clandestine
comunismo	communisme
perfiles	profils
departamentos	départements
cronológico	chronologique
romana	romaine
culpable	coupable
tesorero	trésorier
algoritmos	algorithmes
invitado	invité
liberal	libérale
rupturas	ruptures
pista	piste
meteorología	météorologie
lecciones	leçons
equipo	équipe
anécdota	anecdote
productividad	productivité
mensaje	message
campeonatos	championnats
resoluciones	résolutions
sondeos	sondages
colectivas	collectives
accidentes	accidents
interna	interne
torrentes	torrents
bicentenario	bicentenaire
sindicalista	syndicaliste
rígidas	rigides
atrocidades	atrocités
territorios	territoires
gratuita	gratuite
expertos	experts
sabanas	savanes
padrino	parrain
rentabilidad	rentabilité
suicidios	suicides
diferencial	différentiel
corporación	corporation
parques	parcs
comerciales	commerciaux
privilegiada	privilégiée
automáticos	automatiques
túneles	tunnels
autoritaria	autoritaire
paciente	patient
coral	corail
libertades	libertés
selectiva	sélective
siniestro	sinistre
resucitar	ressusciter
obsoletas	obsolètes
deportados	déportés
garantías	garanties
metal	métal
interactivo	interactif
reutilización	réutilisation
príncipe	prince
conservadurismo	conservatisme
ilegal	illégale
veredicto	verdict
espontáneamente	spontanément
parisino	parisien
separatistas	séparatistes
fracturas	fractures
adultos	adultes
representar	représenter
griegos	grecs
bendición	bénédiction
sindicalismo	syndicalisme
activas	actives
cinturón	ceinture
cerebral	cérébrale
municiones	munitions
ganan	gagnent
flota	flotte
mercenarios	mercenaires
variabilidad	variabilité
grupos	groupes
cubren	couvrent
romanas	romaines
venganza	vengeance
detalles	détails
inviernos	hivers
anomalías	anomalies
radares	radars
solsticio	solstice
etiquetas	étiquettes
infinitamente	infiniment
veteranos	vétérans
finas	fines
refugio	refuge
zonas	zones
interior	intérieur
persistencia	persistance
multinacional	multinationale
neutrales	neutres
recrear	recréer
cromo	chrome
protector	protecteur
legislación	législation
liberar	libérer
vocal	vocale
milicias	milices
entusiasta	enthousiaste
barón	baron
estabilización	stabilisation
plantas	plantes
republicano	républicain
bovinos	bovins
diccionarios	dictionnaires
enciclopedia	encyclopédie
migrantes	migrants
dignidad	dignité
arquitectos	architectes
crédito	crédit
subterráneas	souterraines
financiera	financière
aplicables	applicables
privadas	privées
certificados	certificats
jurisdicción	juridiction
compromiso	compromis
similares	similaires
prematuramente	prématurément
connotación	connotation
persona	personne
respetado	respecté
judicial	judiciaire
humedales	humides
ejercicios	exercices
descripciones	descriptions
naufragio	naufrage
definir	définir
comercialmente	commercialement
espacial	spatiale
navales	navals
perdidas	perdues
armonía	harmonie
fusionando	fusionnent
experimental	expérimentale
indeseables	indésirables
náufragos	naufragés
tablas	tableaux
exclusiva	exclusive
capacidades	capacités
infracciones	infractions
fundación	fondation
contornos	contours
lenguaje	langage
presidentes	présidents
preparatoria	préparatoire
homosexuales	homosexuels
valles	vallées
victoriana	victorienne
régimen	régime
fúnebres	funèbres
nicho	niche
modificar	modifier
sexualidad	sexualité
reconocible	reconnaissable
piloto	pilote
reorganización	réorganisation
mineras	minières
dramas	drames
disuadir	dissuader
apartamentos	appartements
politólogo	politologue
micrófono	micro
criticar	critiquer
historiadores	historiens
momia	momie
socialismo	socialisme
dialéctica	dialectique
fragilidad	fragilité
defensor	défenseur
comercializados	commercialisés
agrícolas	agricoles
bronce	bronze
habitante	habitant
coexistencia	coexistence
sulfato	sulfate
superior	supérieur
gravemente	gravement
habitantes	habitants
excluyendo	excluant
controladores	contrôleurs
honores	honneurs
dominada	dominée
alemana	allemande
gendarmería	gendarmerie
purgatorio	purgatoire
precedente	précédent
razonable	raisonnable
especificaciones	spécifications
misiles	missiles
socialista	socialiste
comediantes	comédiens
financiado	financé
residencial	résidentiel
indio	indien
naciones	nations
sucesión	succession
posición	position
víctimas	victimes
movimientos	mouvements
inundaciones	inondations
integrados	intégrés
horizontalmente	horizontalement
espectáculo	spectacle
ciclos	cycles
dobladas	doublés
revolucionaria	révolutionnaire
sondas	sondes
demolición	démolition
canciller	chancelier
vocación	vocation
síndrome	syndrome
vulgar	vulgaire
contener	contenir
fervor	ferveur
mental	mentale
enanos	nains
plumas	plumes
contribución	contribution
clases	classes
mosqueteros	mousquetaires
flamencos	flamands
prestaciones	prestations
moluscos	mollusques
mexicana	mexicaine
juguetes	jouets
realismo	réalisme
objetivos	objectifs
coordinación	coordination
sectas	sectes
bloqueados	bloqués
contradictorias	contradictoires
provocación	provocation
servicio	service
gabinete	cabinet
robustos	robustes
salarios	salaires
compresión	compression
folclore	folklore
lunar	lunaire
fósiles	fossiles
pastoral	pastorale
composición	composition
previsiones	prévisions
colonia	colonie
correspondencia	correspondance
representaciones	représentations
contables	comptables
pulmones	poumons
horizontes	horizons
relieves	reliefs
disolventes	solvants
fieles	fidèles
descendientes	descendants
termal	thermale
constitucional	constitutionnel
comunes	communes
minero	minier
barriles	barils
comercial	commerciale
increíble	incroyable
inicialmente	initialement
venta	vente
pulmón	poumon
acusados	accusés
medallas	médailles
árabe	arabe
restaurar	restaurer
bombas	bombes
recientes	récentes
limitación	limitation
elites	élites
espectaculares	spectaculaires
artículos	articles
etapas	étapes
depresiones	dépressions
metodología	méthodologie
imitando	imitant
demoler	démolir
copia	copie
electores	électeurs
colonos	colons
contacto	contact
competencias	compétences
sería	serait
división	division
cometer	commettre
observatorio	observatoire
comercializado	commercialisé
volcán	volcan
semana	semaine
personas	personnes
sexos	sexes
impresionado	impressionné
humano	humain
involuntariamente	involontairement
factor	facteur
prefiere	préfère
pluma	plume
iconos	icônes
milicianos	miliciens
superficies	surfaces
cineastas	cinéastes
islamista	islamiste
sociológica	sociologique
triangular	triangulaire
solares	solaires
oratoria	oratoire
inspector	inspecteur
respiratoria	respiratoire
pasión	passion
rápidamente	rapidement
proclamar	proclamer
decisivas	décisives
publicaciones	publications
especímenes	spécimens
parlamentos	parlements
pastor	pasteur
consecuencias	conséquences
colisiones	collisions
reservados	réservés
creativa	créative
opciones	options
incidentes	incidents
serpientes	serpents
experiencias	expériences
interfaz	interface
puntos	points
horarios	horaires
infinita	infinie
capitalización	capitalisation
reducciones	réductions
desorden	désordre
supresión	suppression
control	contrôle
grupo	groupe
compensación	compensation
efecto	effet
explotada	exploitée
razonamiento	raisonnement
disolvente	solvant
perpetua	perpétuité
formato	format
dominado	dominé
desmantelamiento	démantèlement
inspectores	inspecteurs
portal	portail
beneficiarios	bénéficiaires
tragedias	tragédies
plazas	places
exposiciones	expositions
reivindicación	revendication
mecanismos	mécanismes
conductor	conducteur
fiebre	fièvre
apariencias	apparences
sanciones	sanctions
evitando	évitant
concepción	conception
octubre	octobre
piratas	pirates
bomba	bombe
irregularidades	irrégularités
bizantina	byzantine
directos	directs
antisemita	antisémite
italianos	italiens
catalanes	catalans
torrente	torrent
prioritaria	prioritaire
sinagogas	synagogues
dividir	diviser
prevención	prévention
materna	maternelle
consolidar	consolider
fichero	fichier
habitada	habitée
paisaje	paysage
pintó	peint
informado	informé
sucesivas	successives
gloriosa	glorieuse
estricta	stricte
feministas	féministes
negativas	négatives
bloqueado	bloqué
puentes	ponts
distorsión	distorsion
traducción	traduction
inspiradas	inspirées
porcelana	porcelaine
difíciles	difficiles
ideas	idées
misión	mission
elemento	élément
zombis	zombies
burgueses	bourgeois
prescripción	prescription
diamantes	diamants
presión	pression
modificados	modifiés
mineral	minérale
movilización	mobilisation
colectivamente	collectivement
condenar	condamner
lentamente	lentement
compatriotas	compatriotes
formales	formelles
combatientes	combattants
dialecto	dialecte
interdisciplinario	interdisciplinaire
droga	drogue
proceso	processus
veinte	vingt
equivalentes	équivalentes
margen	marge
rodante	roulant
foros	forums
artificial	artificielle
dominados	dominés
cooperación	coopération
difusión	diffusion
observadores	observateurs
mandarín	mandarin
genocidio	génocide
irlandeses	irlandais
respeto	respect
interacciones	interactions
exámenes	examens
construidos	construits
japonesas	japonaises
proteínas	protéines
ridículo	ridicule
moderación	modération
catalana	catalane
diques	digues
argentina	argentine
incidente	incident
candidatura	candidature
durar	durer
confirmando	confirmant
universitaria	universitaire
majestad	majesté
ruleta	roulette
general	général
difícil	difficile
reuniones	réunions
inconvenientes	inconvénients
complementaria	complémentaire
anomalía	anomalie
absorbido	absorbé
poéticos	poétiques
noviembre	novembre
externos	externes
explicación	explication
comercio	commerce
millar	millier
libanesa	libanaise
morir	mourir
contribuye	contribue
magia	magie
humanitarias	humanitaires
lecturas	lectures
vapores	vapeurs
crear	créer
importado	importé
concepciones	conceptions
exteriores	extérieures
actividades	activités
reservar	réserver
prima	prime
menta	menthe
jurista	juriste
productores	producteurs
anexos	annexes
sentimientos	sentiments
propias	propres
gratuitos	gratuits
defendía	défendait
formados	formés
gubernamentales	gouvernementales
curiosamente	curieusement
brutalidad	brutalité
plataformas	plates-formes
ligeros	légers
kurda	kurde
hostil	hostile
lenguajes	langages
tolerancia	tolérance
empleador	employeur
reflejar	refléter
racismo	racisme
ambiciones	ambitions
vagones	wagons
guardiana	gardienne
limitar	limiter
padres	parents
programación	programmation
incapaces	incapables
inmediatos	immédiats
tutela	tutelle
estructurada	structurée
mineros	miniers
consulta	consultation
respectivamente	respectivement
anales	annales
modestos	modestes
pensador	penseur
lenta	lente
castas	castes
contribuyen	contribuent
criterio	critère
relanzar	relancer
billete	billet
compuestos	composés
preparativos	préparatifs
escolar	scolaire
interesante	intéressant
prometido	promis
comisión	commission
temperamento	tempérament
definitivo	définitif
policía	police
récords	records
populares	populaires
ambiguo	ambigu
escuadrones	escadrons
parámetros	paramètres
monumentos	monuments
publicidad	publicité
colonias	colonies
cultura	culture
laboratorio	laboratoire
rumores	rumeurs
financieras	financières
minutos	minutes
decisión	décision
rumanas	roumaines
bienal	biennale
cable	câble
masivamente	massivement
admirador	admirateur
definiciones	définitions
cantó	chanté
iniciativas	initiatives
asamblea	assemblée
capitulación	capitulation
centros	centres
administraciones	administrations
mercurio	mercure
magistratura	magistrature
directiva	directive
climas	climats
rectángulo	rectangle
consultor	consultant
autónomas	autonomes
artificiales	artificielles
aplicaciones	applications
compasión	compassion
compartimentos	compartiments
políticamente	politiquement
fértil	fertile
frecuencias	fréquences
mártires	martyrs
pasajero	passager
universidades	universités
cuestionario	questionnaire
permitido	permis
australianos	australiens
diversificación	diversification
monólogo	monologue
homogéneas	homogènes
fértiles	fertiles
economías	économies
actualmente	actuellement
mitin	meeting
positivos	positifs
activo	actif
delimitado	délimité
transiciones	transitions
externo	externe
escandinavos	scandinaves
prometedor	prometteur
correctamente	correctement
dulce	douce
representan	représentent
sigla	sigle
concentración	concentration
tradición	tradition
aéreas	aériennes
clasificación	classification
españolas	espagnoles
campaña	campagne
lector	lecteur
correo	courrier
sexualmente	sexuellement
partes	parties
culinaria	culinaire
incendios	incendies
músculos	muscles
obreros	ouvriers
pacifista	pacifiste
ojivas	ogives
soluciones	solutions
tecnologías	technologies
vacantes	vacants
olivos	oliviers
progreso	progrès
electoral	électorale
tentación	tentation
civilización	civilisation
privados	privés
importaciones	importations
colonizar	coloniser
nación	nation
simpatizantes	sympathisants
modificado	modifié
francófonos	francophones
consultas	consultations
descritos	décrits
conservadora	conservatrice
cheque	chèque
recomendación	recommandation
humana	humaine
respeta	respecte
protagonistas	protagonistes
preocupaciones	préoccupations
belga	belge
problemas	problèmes
intercontinental	intercontinentale
monasterios	monastères
aleatoria	aléatoire
separar	séparer
ilustrado	illustré
conceptos	concepts
solidaridad	solidarité
terroristas	terroristes
coloración	coloration
natación	natation
individuos	individus
optimista	optimiste
íntimas	intimes
listas	listes
rápidas	rapides
portales	portails
declaraciones	déclarations
órganos	organes
descentralización	décentralisation
explotaciones	exploitations
secretos	secrets
dictador	dictateur
resumir	résumer
convertidor	convertisseur
furor	fureur
determinación	détermination
concentraciones	concentrations
solar	solaire
cotizaciones	cotisations
mantenimiento	maintien
palestina	palestinienne
partículas	particules
sauces	saules
pensión	pension
atraen	attirent
aclamado	acclamé
finés	finnois
combinar	combiner
misteriosamente	mystérieusement
litio	lithium
fondos	fonds
disidentes	dissidents
vacas	vaches
homólogos	homologues
implícitamente	implicitement
insecto	insecte
traducciones	traductions
colecciones	collections
convenciones	conventions
adaptar	adapter
temporal	temporaire
bancaria	bancaire
superioridad	supériorité
dispersos	dispersés
corrosión	corrosion
divergencia	divergence
energética	énergétique
redistribución	redistribution
misiones	missions
rinoceronte	rhinocéros
universal	universel
impulsos	impulsions
comprometer	compromettre
lingüistas	linguistes
contactos	contacts
pasarela	passerelle
mexicanos	mexicains
masculinos	masculins
vicepresidentes	vice-présidents
indicativo	indicatif
internautas	internautes
poemas	poèmes
centenario	centenaire
resultados	résultats
capacidad	capacité
descolonización	décolonisation
legislativas	législatives
formaciones	formations
provincia	province
oponentes	opposants
subjetiva	subjective
escenarios	scénarios
colores	couleurs
fachadas	façades
camiones	camions
anecdótico	anecdotique
clanes	clans
prensas	presses
contemporáneo	contemporain
tensión	tension
tendencia	tendance
tractores	tracteurs
combates	combats
reformas	réformes
gobernanza	gouvernance
competitividad	compétitivité
alternan	alternent
campeonato	championnat
excéntrica	excentrique
restaurantes	restaurants
ligeramente	légèrement
promesas	promesses
humanitaria	humanitaire
capitán	capitaine
balones	ballons
reproducciones	reproductions
inaccesible	inaccessible
enzimas	enzymes
óptima	optimale
series	séries
millas	milles
solemnemente	solennellement
identificable	identifiable
espiritual	spirituel
reconquista	reconquête
mayoritaria	majoritaire
personalidades	personnalités
balance	bilan
sociología	sociologie
reimpresión	réimpression
automatizado	automatisé
protestantes	protestants
independiente	indépendante
detección	détection
amenazas	menaces
educativo	éducatif
aumentado	augmenté
resume	résume
temperatura	température
colectivo	collectif
visibilidad	visibilité
protegen	protègent
trimestral	trimestriel
central	centrale
discípulo	disciple
provinciales	provinciaux
progresistas	progressistes
dificultad	difficulté
cuestión	question
convicciones	convictions
asimilados	assimilés
documentales	documentaires
explicar	expliquer
situaciones	situations
parlamentaria	parlementaire
conversión	conversion
neutralidad	neutralité
contable	comptable
destrucción	destruction
fusionada	fusionnée
asimétrica	asymétrique
cuatro	quatre
europeo	européen
contradicciones	contradictions
manipulaciones	manipulations
metabolismo	métabolisme
espectros	spectres
camión	camion
decorativos	décoratifs
bovino	bovine
incompleta	incomplète
controversia	controverse
fotografiar	photographier
drama	drame
anglicana	anglicane
colectividades	collectivités
condición	condition
guiadas	guidées
autóctona	autochtone
manifestación	manifestation
moral	morale
intelectual	intellectuelle
comparten	partagent
paisajista	paysagiste
colectiva	collective
naturaleza	nature
magistrados	magistrats
submarinos	sous-marins
facetas	facettes
miles	milliers
inestable	instable
mandato	mandat
planes	plans
controvertida	controversée
paisajes	paysages
penales	pénales
legislatura	législature
sugiere	suggère
calcio	calcium
reliquia	relique
operativo	opérationnel
naturalización	naturalisation
bilingüe	bilingue
apartamento	appartement
tecnología	technologie
civiles	civils
retransmisión	retransmission
radicalmente	radicalement
alcoholes	alcools
conector	connecteur
libremente	librement
métodos	méthodes
diferenciación	différenciation
células	cellules
confirman	confirment
inscritos	inscrits
operación	opération
plenipotenciario	plénipotentiaire
coroneles	colonels
pronunciación	prononciation
error	erreur
berlinés	berlinois
jueces	juges
comparaciones	comparaisons
militantes	militants
australianas	australiennes
barras	barres
religión	religion
contribuido	contribué
judiciales	judiciaires
respetar	respecter
extraordinaria	extraordinaire
concordia	concorde
prostitución	prostitution
violaciones	violations
tibetano	tibétain
metro	métro
junta	junte
eminentes	éminents
democracia	démocratie
protestas	protestations
positiva	positive
asambleas	assemblées
accesibles	accessibles
protectores	protecteurs
crucifijo	crucifix
secretas	secrètes
instituto	institut
budistas	bouddhistes
diligencia	diligence
patrimonio	patrimoine
interiores	intérieures
vietnamita	vietnamien
delegaciones	délégations
sanguínea	sanguine
representados	représentés
bombardear	bombarder
magnesio	magnésium
tierras	terres
desaparición	disparition
testamento	testament
planetas	planètes
endémica	endémique
transformar	transformer
superficie	surface
nacionalidad	nationalité
guerrilla	guérilla
menciones	mentions
participa	participe
fracciones	fractions
logotipos	logos
oficiales	officielles
pasaporte	passeport
austriacos	autrichiens
vertical	verticale
centralizada	centralisée
epidemias	épidémies
sensibilidad	sensibilité
volcanes	volcans
explotado	exploité
animaciones	animations
marina	marine
institutos	instituts
indirecta	indirecte
resistir	résister
ataques	attaques
elementales	élémentaires
tenis	tennis
catedral	cathédrale
príncipes	princes
magnetismo	magnétisme
bombardero	bombardier
argumentos	arguments
interpretaciones	interprétations
plantada	plantée
barreras	barrières
contradicción	contradiction
triangulares	triangulaires
monje	moine
funcionales	fonctionnels
condiciones	conditions
potencialmente	potentiellement
triángulo	triangle
garantizar	garantir
preferencias	préférences
clandestino	clandestin
modifica	modifiant
regionalista	régionaliste
aristócratas	aristocrates
creaciones	créations
crímenes	crimes
orientaciones	orientations
inmobiliario	immobilier
invitaciones	invitations
necesariamente	nécessairement
fusionar	fusionner
argentino	argentin
nómada	nomade
autóctonas	autochtones
rampa	rampe
mensajeros	messagers
responsabilidades	responsabilités
direcciones	directions
voluntarias	volontaires
consultores	consultants
fiscal	fiscale
toxicidad	toxicité
tortuga	tortue
convoy	convoi
revisiones	révisions
popular	populaire
vestigio	vestige
combinado	combiné
limitadas	limitées
vacante	vacant
historiador	historien
movilizar	mobiliser
instituciones	institutions
ultimátum	ultimatum
recurso	recours
contribuciones	contributions
temperaturas	températures
guerrera	guerrière
balísticos	balistiques
protesta	protestation
sexual	sexuelle
centrista	centriste
inmobiliarias	immobilières
colombiano	colombien
potenciales	potentiels
esterlinas	sterling
organizaciones	organisations
designar	désigner
haitiano	haïtien
representativa	représentative
internacionales	internationales
adulta	adulte
escepticismo	scepticisme
pragmática	pragmatique
tráfico	trafic
litro	litre
cooperativa	coopérative
ángeles	anges
sustancia	substance
occidental	occidentale
constituciones	constitutions
platos	plats
variar	varier
discoteca	discothèque
infectados	infectés
candidatos	candidats
excluido	exclu
leones	lions
hombre	homme
mediocres	médiocres
gérmenes	germes
favoritos	favoris
filtro	filtre
distancias	distances
silvicultura	sylviculture
aislar	isoler
institución	institution
sudafricano	sud-africain
segmentos	segments
independentista	indépendantiste
diplomas	diplômes
rehabilitación	réhabilitation
religiones	religions
patrióticas	patriotiques
ciclistas	cyclistes
desarme	désarmement
híbrida	hybride
silencio	silence
reportaje	reportage
controlados	contrôlés
visionario	visionnaire
multinacionales	multinationales
gigante	géant
hierbas	herbes
intervenciones	interventions
controlado	contrôlé
rayos	rayons
frío	froid
iniciativa	initiative
consumir	consommer
caricatura	caricature
tortura	torture
mensajes	messages
ficciones	fictions
genes	gènes
propulsión	propulsion
hoteles	hôtels
desintegración	désintégration
tradicional	traditionnelle
intensiva	intensive
cualificados	qualifiés
caravana	caravane
parentesco	parenté
especialistas	spécialistes
dopaje	dopage
representada	représentée
constitucionales	constitutionnelles
hectáreas	hectares
publicados	publiés
limitado	limité
drogas	drogues
cognitivas	cognitives
determinantes	déterminants
combinada	combinée
biblia	bible
circula	circule
horizontal	horizontale
marea	marée
combinando	combinant
constitución	constitution
vendidos	vendus
turistas	touristes
magistrado	magistrat
promesa	promesse
convocar	convoquer
manipulación	manipulation
hostilidades	hostilités
fruto	fruit
clero	clergé
sudamericano	sud-américain
retorno	retour
rotación	rotation
creíble	crédible
hidrocarburos	hydrocarbures
marxistas	marxistes
talento	talent
mexicano	mexicain
semanas	semaines
corso	corse
sección	section
fragmentación	fragmentation
ejemplos	exemples
sexuales	sexuels
cristianismo	christianisme
deforestación	déforestation
guerras	guerres
reconquistar	reconquérir
complejas	complexes
carrusel	carrousel
contribuir	contribuer
publicitarias	publicitaires
consular	consulaire
futuras	futures
invasiones	invasions
militarmente	militairement
coherencia	cohérence
desfavorable	défavorable
contemporáneos	contemporains
kilómetros	kilomètres
representativo	représentatif
certificación	certification
pasiones	passions
clientes	clients
domesticación	domestication
diversificar	diversifier
profesionalización	professionnalisation
españoles	espagnols
princesa	princesse
contrapartida	contrepartie
fácil	facile
detectores	détecteurs
partido	parti
ediciones	éditions
independentistas	indépendantistes
construir	construire
participaban	participaient
repatriados	rapatriés
monetarias	monétaires
cobalto	cobalt
tratamientos	traitements
circunscripción	circonscription
aceptable	acceptable
marinas	marines
ordinario	ordinaire
nobleza	noblesse
gestión	gestion
reserva	réserve
español	espagnol
profundidades	profondeurs
imposibles	impossibles
categorías	catégories
aéreo	aérien
contra	contre
médicos	médecins
imágenes	images
cobertura	couverture
notas	notes
vitalidad	vitalité
circunscripciones	circonscriptions
promover	promouvoir
estatuto	statut
inmediata	immédiate
depende	dépend
dictadura	dictature
adversarios	adversaires
bloques	blocs
defensivo	défensif
independientes	indépendants
complejidad	complexité
doblaje	doublage
confirmadas	confirmées
prerrogativas	prérogatives
diamante	diamant
árabes	arabes
regularmente	régulièrement
fácilmente	facilement
superestrella	superstar
ilustran	illustrent
playas	plages
intacta	intacte
organizadores	organisateurs
mareas	marées
sólidos	solides
forzando	forçant
polarización	polarisation
tendencias	tendances
respiratorias	respiratoires
citar	citer
monografías	monographies
fronterizos	frontaliers
intensivo	intensif
cascada	cascade
clubes	clubs
ruptura	rupture
flexibilidad	flexibilité
escándalo	scandale
alianza	alliance
codificación	codification
híbridas	hybrides
sharia	charia
abandonados	abandonnés
concluir	conclure
recompensa	récompense
plomo	plomb
océanos	océans
prólogo	prologue
monarca	monarque
diplomáticas	diplomatiques
calculado	calculé
imposible	impossible
céntimos	centimes
negociar	négocier
etnias	ethnies
imaginarias	imaginaires
directamente	directement
otomano	ottoman
recomienda	recommande
colectividad	collectivité
albanés	albanais
contrarias	contraires
macedonia	macédonienne
abstracto	abstrait
economista	économiste
futura	future
restauración	restauration
coproducción	coproduction
excluidos	exclus
inminente	imminente
generaciones	générations
tratamiento	traitement
rotaciones	rotations
criminal	criminel
prefecto	préfet
enterrada	enterrée
granadas	grenades
modernas	modernes
defensivos	défensifs
