1500-luvun	1500
1600-luvun	1600
1700-luvun	1700
1800-luvun	1800
aachen	aachen
aachenin	aacheni
aadolf	adolf
aalberg	aalberg
aalborgin	aalborgi
aale	aale
aaltonen	aaltonen
äänekosken	äänekoski
äänetön	hääletu
äänisen	äänisjärve
äänisenrannan	äänisranna
aarne	aarne
aarnio	aarnio
aarno	aarno
aaro	aaro
aaron	aaron
aasialainen	aasia
aasian	aasia
aatami	aatami
aatos	aatos
aava	aava
abba	abba
abbas	‘abbās
abbot	abbot
abbott	abbott
abby	abby
abdel	abdel
abdi	cabdi
abdullah	abdullah
abdullah	‘abdullāh
abdullah	allāh
abel	abel
abelin	abeli
abercrombie	abercrombie
aberdeen	aberdeen
aberdeenin	aberdeeni
åbo	åbo
abraham	abraham
abrahams	abrahams
abram	abram
abramovitš	abramovitš
abreu	abreu
absoluuttinen	absoluutne
abstrakti	abstraktne
academia	academia
académie	académie
academy	academy
accademia	accademia
access	access
aceh	aceh
acer	acer
achtung	achtung
acid	acid
ackermann	ackermann
ackté	ackté
acta	acta
active	active
adam	adam
adamou	adámou
adams	adams
adamsin	adamsi
adamson	adamson
addams	addams
addis	addis
addisonin	addisoni
adel	adel
adler	adler
admiral	admiral
adobe	adobe
adolf	adolf
adolfo	adolfo
adolph	adolph
adolphe	adolphe
adriana	adriana
adrian	adrian
adriano	adriano
adrianopolin	adrianoopoli
adrien	françois-adrien
advanced	advanced
advancement	advancement
adygeian	adõgee
aegean	aegean
aero	aero
aeroflotin	aerofloti
affleck	affleck
afganistan	afganistan
afganistanin	afganistani
afonso	afonso
african	african
africanus	africanus
afrikan	aafrika
afrikka	aafrika
afrikkalainen	aafrika
afrikka	lõuna-aafrika
agamemnonin	agamemnoni
agatha	agatha
agenda	agenda
agent	agent
ágios	ágios
agnew	agnew
agnieszka	agnieszka
agostino	agostino
ågren	ågren
agricola	agricola
agrippa	agrippa
agrippina	agrippina
aguilera	aguilera
aguri	aguri
agustín	agustín
ahead	ahead
ahlberg	ahlberg
ahlfors	ahlfors
ahlqvist	ahlqvist
ahlroth	ahlroth
ahmad	aḩmad
ahmatova	ahmatova
ahmed	ahmed
ahmed	axmed
ahmet	ahmet
ahola	ahola
ahonen	ahonen
ähtärin	ähtäri
ahti	ahti
ahtisaari	ahtisaari
ahvenanmaan	ahvenamaa
aichin	aichi
aida	aida
aija	aija
aiken	aiken
aimo	aimo
aine	aine
aineeton	vaimne
aino	aino
ain’t	ain't
airbus	airbus
airesin	airese
airin	airi
airlines	airlines
airlinesin	airlinesi
airways	airways
airwaysin	airwaysi
ajanlasku	skaala
ajax	ajax
akademi	akademi
akateeminen	akadeemiline
akatemia	akadeemia
akbar	akbar
åke	åke
akhaian	ahhaia
akira	akira
akita	akita
aksel	aksel
akseli	akseli
aksumin	aksumi
aktiivisuus	aktiivsus
akustinen	akustiline
akvedukti	akvedukt
alabama	alabamas
aladdin	aladdin
alain	alain
alamedan	alameda
alan	alan
åland	åland
alanis	alanis
alankomaat	madalmaad
alankomaiden	madalmaade
alaskan	alaska
al-assad	al-asad
alastair	alastair
alava	alava
alba	alba
alban	alban
albanian	albaania
albanyn	albany
albers	albers
albert	albert
alberti	alberti
alberto	alberto
albion	albion
albrekt	albrecht
albright	albright
albuquerque	albuquerque
albus	albus
alcalá	alcalá
alcohol	alcohol
alden	alden
al-din	ad-dīn
aldo	aldo
aldous	aldous
aldrin	aldrin
alec	alec
alegre	alegre
alehin	alehhin
alejandro	alejandro
aleksandar	aleksandar
aleksander	aleksander
aleksandra	aleksandra
aleksandr	aleksandr
aleksandrialainen	aleksandriast
aleksandrian	aleksandria
aleksandrov	aleksandrov
aleksandrovitš	aleksandrovitš
aleksanteri	aleksander
aleksejev	aleksejev
aleksi	aleksi
aleksin	aleksin
aleksis	aleksis
alen	ale
alén	alén
aleppon	aleppo
alesi	alesi
alessandro	alessandro
alex	alex
alexander	alexander
alexandra	alexandra
alexandre	alexandre
alexandru	alexandru
alfa	alfa
alfonso	alfonso
alfredo	alfredo
algebra	algebra
algebrallinen	algebraline
algeria	alžeeria
algerian	alžeeria
algoritmi	algoritm
algot	algot
alice	alice
alicia	alicia
alina	alina
alison	alison
alive	alive
aljaksandr	alaksandr
alkeenien	alkeenide
alla	all
alla	alla
allan	allan
allas	allas
allen	allen
allende	allende
allenin	alleni
allgemeine	allgemeine
alliance	alliance
allison	allison
allman	allman
ally	ally
alma	alma
almería	almería
almqvist	almquist
alois	alois
alonen	alonen
alonso	alonso
alonzo	alonzo
aloysius	aloisius
alpha	alpha
alphonse	alphonse
alpo	alpo
altain	altai
alter	alter
alternative	alternative
altman	altman
alto	alto
alttari	altar
aluejako	haldusjaotus
alva	alva
alvar	alvar
alvarez	alvarez
álvarez	álvarez
álvaro	álvaro
alves	alves
alvin	alvin
älvsborgin	älvsborgi
alyson	alyson
alzheimerin	alzheimeri
amadeus	amadeus
amado	amado
amanda	amanda
amaral	amaral
amazon	amazon
amazon	amazonas
amazonasin	amazonase
amber	amber
ambrose	ambrose
amedeo	amedeo
amelia	amelia
amélie	amélie
america	america
américa	américa
american	ameerika
american	american
amerikan	ameerika
amerikkalainen	ameerika
amiensin	amiens'i
amin	amin
amin	amīn
aminohappo	aminohapped
amir	amir
ammattiyhdistysten	ametiühingute
amnesty	amnesty
amos	amos
amsterdamin	amsterdami
amsterdam	uus-amsterdam
amundsen	amundsen
amurin	amuuri
anabel	anabel
anaheim	anaheim
analyysi	analüüs
analyyttinen	analüütiline
anand	anand
anarchy	anarchy
anarkiaa	anarhia
anarkismi	anarhism
anastasija	anastassija
anatoli	anatoli
anatomia	anatoomia
anders	anders
andersen	andersen
anderson	anderson
andersson	andersson
andhra	andhra
andorra	andorra
andorran	andorra
andrade	andrade
andrás	andrás
andrea	andrea
andreaksen	andrease
andré	andré
andrée	andrée
andrej	andrej
andrejev	andrejev
andres	andres
andrés	andrés
andrew	andrew
andrews	andrews
andri	andri
andromeda	andromeeda
andromedan	andromeeda
andronikos	andronikos
andrus	andrus
andrzej	andrzej
andy	andy
angela	angela
angel	angel
ángel	ángel
angeles	angeles
angelesin	angelese
angelica	angelica
angelica	angelika
angelika	angelika
angelina	angelina
angelin	angeli
angels	angels
anger	anger
angerkoski	angerkoski
angie	angie
angola	angola
angolan	angola
angry	angry
animal	animal
animals	animals
aniston	aniston
anita	anita
anja	anja
anjalan	anjala
ankara	ankara
ankaran	ankara
anna	anna
anna-leena	anna-leena
anna-liisa	anna-liisa
annan	annan
anne	anne
anneli	anneli
anne-marie	anne-marie
annette	annette
anni	anni
annie	annie
ansar	anşār
ansipin	ansipi
anssi	anssi
antanas	antanas
antarktiksen	antarktika
antero	antero
anthony	anthony
anti	anti
antigua	antigua
antillien	antillide
antoine	antoine
antoinette	antoinette
anton	anton
antoni	antoni
antonin	antonin
antoninus	antoninus
antonio	antonio
antónio	antónio
antônio	antônio
antonius	antonius
antonov	antonov
antony	antony
antropologia	antropoloogia
ants	ants
anttila	anttila
antwerpenin	antwerpeni
anwar	anwar
aomorin	aomori
apache	apache
apart	apart
apenniinien	apenniini
apes	apes
apinoiden	ahvide
apollo	apollo
apollodoros	apollodoros
apollonios	apollonios
apostolien	apostlite
apostolinen	apostellik
apostolinen	apostlik
apostolinen	apostlik-õigeusu
appenzell	appenzell
appetite	appetite
apple	apple
appleton	appleton
application	application
aquino	aquino
arabian	araabia
arabimaiden	araabia
arafat	‘arafāt
aragonian	aragoni
arajärvi	arajärvi
aram	aram
aramean	aramea
aravirta	aravirta
arcade	arcade
arch	arch
architecture	architecture
archive	archive
archive	arhiiv
archives	archives
area	area
areena	areena
areena	-areena
arena	arena
åren	åre
arenas	arenas
arendt	arendt
argentiinan	argentina
argo	argo
argumentti	argument
arhinmäki	arhinmäki
århusin	århusi
ariana	ariana
ariane	ariane
aristide	aristide
aritmeettinen	aritmeetiline
arizonan	arizona
arjen	arjen
arkadi	arkadi
arkangelin	arhangelski
arkeologinen	arheoloogiline
arkhimedeen	archimedese
arkkitehtuuri	arhitektuur
arktinen	arktika
arktiset	arktika
arlingtonin	arlingtoni
armand	armand
armando	armando
armas	armas
armenialaisten	armeenlaste
armenian	armeenia
armin	armin
arms	arms
armstrong	armstrong
army	army
arnaud	arnaud
arndt	arndt
arne	arne
arno	arno
arnold	arnold
arnoux	arnoux
aromaattinen	aromaatne
aromaattiset	aromaatsed
aron	aron
arquette	arquette
ar-rahman	ar-raḩmān
arrow	arrow
arsène	arsène
arseni	arseni
artemiin	artemise
arthur	arthur
arti	arti
arto	arto
artturi	artturi
artur	artur
arturo	arturo
arvi	arvi
arvid	arvid
arvo	arvo
arvonen	arvonen
ascari	ascari
aseman	aseman
ashe	ashe
ashley	ashley
asian	aasia
asiana	asiana
asiat	asjad
asikainen	asikainen
asimov	asimov
asko	asko
aslan	aslan
aspelund	aspelund
aspergerin	aspergeri
asplund	asplund
asser	asser
assis	assis
associated	associated
association	association
association	assotsiatsioon
assuanin	assuani
astaire	astaire
asteroidien	asteroidide
aston	aston
astor	ástor
astra	astra
astrahanin	astrahani
astrid	astrid
åström	åström
astrophysical	astrophysical
asturian	astuuria
asylum	asylum
atalanta	atalanta
atari	atari
atatürk	atatürk
ateenalainen	athenagoras
ateenan	ateena
athene	athena
athlon	athlon
atkins	atkins
atkinsin	atkinsi
atkinson	atkinson
atlanta	atlanta
atlantic	atlantic
atlantin	atlandi
atlantin	kesk-atlandi
atlantis	atlantis
atolli	atoll
atom	atom
atomic	atomic
attikan	atika
attila	attila
attraction	attraction
aubrey	aubrey
auckland	auckland
audi	audi
audio	audio
audrey	audrey
audubon	audubon
augsburg	augsburg
augsburgin	augsburgi
august	august
auguste	auguste
augustin	augustin
augustinus	augustinus
augusto	augusto
augustus	augustus
aukko	auk
auld	auld
aulis	aulis
aung	aung
aunuksen	aunuse
aurelianuksen	aurelianuse
austen	austen
austin	austin
australian	austraalia
australis	australis
austrian	austrian
auto	auto
automaattinen	automaatne
autonominen	autonoomne
avant	avant
avaruuskeskus	kosmosekeskus
avaruus	ruum
avaus	avang
avenged	avenged
avenue	avenue
avery	avery
aviv	aviv
avogadron	avogadro
avril	avril
awards	awards
ayala	ayala
ayrton	ayrton
ayumi	ayumi
azarenka	azaranka
azaria	azaria
azerbaidžan	aserbaidžaan
azerbaidžanin	aserbaidžaani
aziz	aziz
azkabanin	azkabani
azorien	assooride
b-52	b-52
baabelin	paabeli
baba	baba
babel	babel
babel	paabel
baby	baby
babylon	babylon
babyn	babõn
bacall	bacall
bacharach	bacharach
bach	bach
bachelet	bachelet
bachelor	bachelor
bachmann	bachmann
back	back
backlund	backlund
bäckman	bäckman
backstreet	backstreet
bacon	bacon
baer	baer
baggio	baggio
bagh	bagh
bahaman	bahama
bahn	bahn
bahrainin	bahreini
bahtin	bahtin
baijerilainen	baierist
baijerin	baieri
baikonurin	bajkongõri
bailey	bailey
baines	baines
baird	baird
baja	baja
bakerin	bakeri
bakr	bakr
bakteeri	bakterid
baku	bakuu
bakun	bakuu
bakunin	bakunin
balboa	balboa
balduin	balduin
baldwin	baldwin
baldwinin	baldwini
balin	bali
balkanin	balkani
ball	ball
ballet	ballet
ballet	-ballett
balls	balls
balotelli	balotelli
baltian	balti
baltica	baltica
baltica	baltika
baltic	baltic
baltimore	baltimore
bambi	bambi
banaani	banaan
banco	banco
banda	banda
band	band
band	bigbänd
bang	bang
bangladeshin	bangladeshi
bank	bank
banks	banks
banner	banner
banská	banská
baptiste	baptiste
barack	barack
barak	barak
barbadoksen	barbadose
barbarossa	barbarossa
barber	barber
barbie	barbie
barbora	barbora
barbra	barbra
barcelona	barcelona
barclay	barclay
bardot	bardot
bari	bari
barin	bari
bark	bark
barker	barker
barker	barkeri
barkley	barkley
barkov	barkov
bärlund	bärlund
barnard	barnard
barnett	barnett
barney	barney
baron	baron
barre	barre
barrett	barrett
barroso	barroso
barrow	barrow
barry	barry
bart	bart
barth	barth
bartholomew	bartholomew
bartók	bartók
bartoli	bartoli
bartolomé	bartolomé
bartolomeo	bartolomeo
base	base
basel	basel
baselin	baseli
basic	basic
basilika	basiilika
baskervillen	baskerville'ide
basket	basket
baskimaa	baskimaa
baskimaan	baskimaa
baskin	baski
baškortostanin	baškortostani
basset	basset
bastard	bastard
bastian	bastian
bateman	bateman
bates	bates
batista	batista
batman	batman
batmanin	batmani
baton	baton
battista	battista
battle	battle
battlefield	battlefield
baudelaire	baudelaire
bauer	bauer
baumann	baumann
baumgartner	baumgartner
beach	beach
beagle	beagle
bean	bean
bear	bear
bears	bears
beast	beast
beastie	beastie
beata	beata
beat	beat
beatles	beatles
beatrice	beatrice
beatrix	beatrix
beatty	beatty
beau	beau
beaufortin	beauforti
beautiful	beautiful
beauvoir	beauvoir
beck	beck
becker	becker
beckett	beckett
beckham	beckham
becky	becky
becquerel	becquerel
bedingfield	bedingfield
beethoven	beethoven
begin	begin
beginning	beginning
beiträge	beiträge
béla	béla
belaja	belaja
belgialaisten	belglaste
belgian	belgia
belgradin	belgradi
believe	believe
belinda	belinda
belizen	belize'i
bella	bella
bellamy	bellamy
bell	bell
belle	belle
bellen	bellen
bellini	bellini
belo	belo
belong	belong
bend	bend
beneath	beneath
benedict	benedict
benedictus	benedictus
benetton	benetton
benfica	benfica
bengalin	bengali
bengtskärin	bengtskäri
bengtsson	bengtsson
beniamino	beniamino
beninin	benini
benítez	benítez
benito	benito
benjamin	benjamin
benji	benji
bennett	bennett
bennington	bennington
benny	benny
benois	benois
benoît	benoît
benson	benson
bent	bent
bentham	bentham
bentley	bentley
benton	benton
benz	benz
berdych	berdych
berenike	berenike
bereniken	berenike
berezovski	berezovski
bergamon	bergamo
berg	berg
bergen	bergen
bergenin	bergeni
berger	berger
bergin	bergi
berglund	berglund
bergman	bergman
bergqvist	bergqvist
berija	beria
berkeley	berkeley
berklee	berklee
berkshire	berkshire
berliinin	berliini
berlin	berlin
berliner	berliner
berlioz	berlioz
berlusconi	berlusconi
bermudan	bermuda
bernadette	bernadette
bernadotte	bernadotte
bernard	bernard
bernardino	bernardino
bernardo	bernardo
bernd	bernd
berndt	berndt
berner	berner
bernhard	bernhard
bernhardt	bernhardt
bernie	bernie
bernin	berni
bernoulli	bernoulli
bernoullin	bernoulli
bernstein	bernstein
bernt	bernt
berry	berry
berta	berta
bert	bert
bertha	bertha
berthold	berthold
bertil	bertil
bertolt	bertolt
bertrand	bertrand
besant	besant
bess	bess
beth	beth
bette	bette
better	better
betty	betty
beverly	beverly
beyoncé	beyoncé
beyond	beyond
bhutanin	bhutani
bianchi	bianchi
biaudet	biaudet
bibliografia	bibliograafia
bieber	bieber
bielke	bielke
biennaali	biennaal
bilbao	bilbao
bilbo	bilbo
bildt	bildt
bill	bill
billboard	billboard
billie	billie
billy	billy
bing	bing
bingham	bingham
bint	bint
biologinen	bioloogiline
biologinen	füüsiline
bird	bird
birdlife	birdlife
birds	birds
birger	birger
birgit	birgit
birgitta	birgitta
birmingham	birmingham
birminghamin	birminghami
biron	biron
bishop	bishop
bismarck	bismarck
bison	bison
bite	bite
bizarre	bizarre
björklund	björklund
björkman	björkman
björn	björn
bjørn	bjørn
bjurström	bjurström
blackbird	blackbird
black	black
blackburn	blackburn
blackpool	blackpool
blade	blade
blair	blair
blaise	blaise
blake	blake
blanc	blanc
blanchard	blanchard
blanchett	blanchett
blanka	blanka
blavatsky	blavatskaja
blaze	blaze
blazers	blazers
blekingen	blekinge
bletchley	bletchley
bleu	bleu
blind	blind
blitz	blitz
blizzard	blizzard
block	block
blohm	blohm
blom	blom
blomqvist	blomqvist
blood	blood
bloom	bloom
bloomfield	bloomfield
bloomin	bloomi
blossom	blossom
blow	blow
blue	blue
blues	blues
blues	bluus
bluetooth	bluetooth
blunt	blunt
boateng	boateng
bobby	bobby
bobi	bobi
bobrikov	bobrikov
boccaccio	boccaccio
bochum	bochum
bode	bode
bodenin	bodeni
bodom	bodom
boeing	boeing
boer	boer
bogdan	bogdan
bohrin	bohri
boije	boije
bojan	bojan
boko	boko
boksitogorskin	boksitogorski
boleyn	boleyn
bolívar	bolívar
bolivian	boliivia
boll	boll
bollée	bollée
bologna	bologna
bolognan	bologna
bolt	bolt
bolton	bolton
boltzmannin	boltzmanni
bombardier	bombardier
bonaparte	bonaparte
bondarenko	bondarenko
bond	bond
bonde	bonde
bondin	bondi
bone	bone
boney	boney
bongo	bongo
bonham	bonham
bonner	bonner
bonnet	bonnet
bonnie	bonnie
bonnin	bonni
bono	bono
boolen	boole'i
booth	booth
border	border
borg	borġ
borges	borges
borgir	borgir
boris	boris
boris	boriss
börje	börje
bormann	bormann
born	born
borodinon	borodino
bosch	bosch
bose	bose
bosnia	bosnia
bosque	bosque
bostonin	bostoni
botha	botha
botswana	botswana
bottas	bottas
boucher	boucher
boulanger	boulanger
boulevard	boulevard
boulogne	boulogne
bourne	bourne
bournemouthin	bournemouthi
bouvier	bouvier
bowen	bowen
bowie	bowie
bowl	bowl
boxer	boxer
boyce	boyce
boyd	boyd
boyer	boyer
boyle	boyle
boys	boys
b-puoli	b-pool
brabantin	brabanti
brad	brad
bradbury	bradbury
bradford	bradford
bradley	bradley
brady	brady
braga	braga
brahe	brahe
brahms	brahms
bram	bram
branco	branco
brand	brand
brandenburgin	brandenburgi
brando	brando
brands	brands
brandt	brandt
brasileiro	brasileiro
brasilialainen	brasiilia
brasilian	brasiilia
bratislavan	bratislava
braun	braun
braunschweig	braunschweig-wolfenbüttel
brave	brave
bravo	bravo
brawn	brawn
brax	brax
break	break
breakfast	breakfast
breda	breda
breivik	breivik
bremer	bremer
brenda	brenda
brendan	brendan
brendon	brendon
brennan	brennan
brentano	brentano
brent	brent
brescia	brescia
brescian	brescia
bresson	bresson
brestin	bresti
brest-litovskin	brest-litovski
bretagnen	bretagne'i
bret	bret
breton	breton
brew	brew
brewer	brewer
brewster	brewster
brežnev	brežnev
brežnevin	brežnevi
brian	brian
bridge	bridge
bridges	bridges
brigitte	brigitte
bring	bring
bringing	bringing
brink	brink
bristolin	bristoli
britannia	britannia
britannian	briti
britannian	suurbritannia
britannica	britannica
british	briti
british	british
britney	britney
brittany	brittany
britten	britten
brittiläisen	briti
brittiläiset	briti
brittiläisten	briti
brjanskin	brjanski
brno	brno
broad	broad
broadcasting	broadcasting
broadway	broadway
broglie	broglie
broglien	broglie
brokeback	brokebacki
broken	broken
bromwich	bromwich
brøndby	brøndby
bronson	bronson
brooklyn	brooklyn
brooklynin	brooklyni
brooks	brooks
bros	bros
brother	brother
brotherhood	brotherhood
brothers	brothers
brown	brown
brownin	browni
broz	broz
bruce	bruce
brucen	bruce'i
bruckner	bruckner
bruins	bruins
brunein	brunei
bruni	bruni
bruno	bruno
brunson	brunson
brunswick	brunswick
brussels	brussels
bryan	bryan
bryant	bryant
bryce	bryce
bryggare	bryggare
bryn	bryn
brysselin	brüsseli
buchanan	buchanan
buch	buch
buckinghamin	buckinghami
buckley	buckley
bucks	bucks
buddy	buddy
buemi	buemi
buenos	buenos
buffon	buffon
bugatti	bugatti
buharan	buhhaara
building	building
bulgaria	bulgaria
bulgarian	bulgaaria
bull	bull
bullets	bullets
bullock	bullock
bulls	bulls
bülow	bülow
bundesliiga	bundesliga
bundesliiga	fußball-bundesliga
bundy	bundy
burckhardt	burckhardt
burdon	burdon
bureau	bureau
buren	buren
burgess	burgess
burgundin	burgundia
burjatian	burjaatia
burke	burke
burkina	burkina
burman	birma
burns	burns
burr	burr
burroughs	burroughs
burrows	burrows
burt	burt
burton	burton
burundi	burundi
burundin	burundi
bury	bury
busch	busch
bush	bush
business	business
busta	busta
butler	butler
butterfly	butterfly
button	button
byrd	byrd
byron	byron
bysanttilainen	bütsantsi
caballero	caballero
cabaret	kabaree
cabernet	cabernet
cable	cable
cabral	cabral
cáceres	cáceres
cadillac	cadillac
caesar	caesar
caetano	caetano
cafe	cafe
café	café
cage	cage
cagliari	cagliari
cagney	cagney
cahill	cahill
caine	caine
cajander	cajander
calabrian	calabria
calcio	calcio
calderón	calderón
caldwell	caldwell
california	california
call	call
calle	calle
calonius	calonius
calvin	calvin
calypso	kalypso
camara	camara
camargo	camargo
cambridgen	cambridge'i
came	came
camel	camel
camera	camera
cameron	cameron
camilla	camilla
camille	camille
camillo	camillo
camilo	camilo
campbell	campbell
camp	camp
campeonato	campeonato
campo	campo
campos	campos
camus	camus
canada	canada
canadiens	canadiens
canal	canal
canaria	canaria
canary	canary
candela	candela
candice	candice
candy	candy
cane	cane
canetti	canetti
canis	canis
cannesin	cannes'i
cannibal	cannibal
canon	canon
can’t	can't
canto	canto
cantor	cantor
cantores	cantores
cantus	cantus
canucks	canucks
capablanca	capablanca
capa	capa
cape	cape
capital	capital
capo	capo
capote	capote
cappella	cappella
capra	capra
captain	captain
caracallan	caracalla
card	card
cardiff	cardiff
cardiffin	cardiffi
cardoso	cardoso
carey	carey
cargo	cargo
caribbean	caribbean
carla	carla
carl	carl
carleton	carleton
carlin	carlin
carlisle	carlisle
carlo	carlo
carlos	carlos
carlsen	carlsen
carlson	carlson
carlsson	carlsson
carly	carly
carlyle	carlyle
carmelo	carmelo
carmen	carmen
carmichael	carmichael
carmina	carmina
carmona	carmona
carnap	carnap
carnegie	carnegie
carnival	carnival
caro	caro
carol	carol
carole	carole
carolina	carolina
caroline	caroline
carradine	carradine
carr	carr
carré	carré
carrey	carrey
carrie	carrie
carrier	carrier
carroll	carroll
cars	cars
carson	carson
carta	carta
carte	carte
carter	carter
carterin	carteri
cartier	cartier
cartoon	cartoon
cartwright	cartwright
caruso	caruso
carvalho	carvalho
cary	cary
casablancan	casablanca
casanova	casanova
case	case
casey	casey
cash	cash
casillas	casillas
casimir	casimir
casino	casino
caspar	caspar
cassidy	cassidy
cassini	cassini
castaneda	castaneda
cast	cast
castel	castel
castellammare	castellammare
castellaneta	castellaneta
castello	castello
castle	castle
castlen	castle'i
castrénin	castréni
castro	castro
catalina	catalina
catania	catania
catanian	catania
cate	cate
caterham	caterham
catherine	catherine
catholic	catholic
cathy	cathy
cato	cato
cats	cats
cavaliers	cavaliers
cave	cave
cavendish	cavendish
ceaușescu	ceaușescu
cecil	cecil
cecilia	cecilia
cedric	cedric
celebration	celebration
celeste	celeste
celine	celine
céline	céline
celsius	celsius
celta	celta
celtics	celtics
centauri	centauri
cent	cent
center	center
centre	centre
centro	centro
cerf	cerf
cervantes	cervantes
cervantes	cervantese
césar	césar
cesare	cesare
cesaris	cesaris
české	české
cessna	cessna
cézanne	cézanne
chacon	chaco
chadwick	chadwick
chagall	chagall
chaim	h̠ayyim
chaka	chaka
challenge	challenge
challenger	challenger
chamakh	chamakh
chamberlain	chamberlain
chambers	chambers
champion	champion
chan	chan
chandler	chandler
chandra	chandra
chanel	chanel
chanel	chaneli
chaney	chaney
chang	chang
change	change
changin	changi
channel	channel
channing	channing
chantal	chantal
chao	chao
chapel	chapel
chaplin	chaplin
chapman	chapman
char	char
charing	charing
charles	charles
charlesin	charlesi
charlestonin	charlestoni
charlie	charlie
charlotte	charlotte
charlton	charlton
chase	chase
chávez	chávez
chef	chef
chelsea	chelsea
chen	chen
cheney	cheney
chet	chet
chevalier	chevalier
chevrolet	chevrolet
chiang	chiang
chiba	chiba
chiban	chiba
chicago	chicago
chicagon	chicago
chí	chí
chico	chico
child	child
childhood	childhood
children	children
chili	chili
chilton	chilton
china	china
chin	chin
chips	chips
chirac	chirac
chisholm	chisholm
chișinău	chișinău
chomsky	chomsky
chopin	chopin
chrétien	chrétien
chris	chris
christa	christa
christ	christ
christensen	christensen
christian	christian
christiane	christiane
christie	christie
christina	christina
christine	christine
christ	kristus
christmas	christmas
christoffer	christoffer
christoph	christoph
christophe	christophe
christopher	christopher
chrome	chrome
chrysler	chrysler
chuck	chuck
chun	chun
chung	chung
churberg	churberg
church	church
churchill	churchill
cibulková	cibulková
cielo	filho
cincinnati	cincinnati
cindy	cindy
cinema	cinema
cinque	cinque
cioran	cioran
cisco	cisco
citroën	citroën
ciudad	ciudad
civic	civic
claes	claes
clair	clairi
claire	claire
clairen	claire'i
clancy	clancy
clapton	clapton
clare	clare
clarence	clarence
claren	clare'i
clarke	clarke
clarkin	clarki
clarkson	clarkson
clas	clas
clash	clash
classical	classical
classic	classic
claude	claude
claudia	claudia
claudio	claudio
claudius	claudius
clay	clay
clayton	clayton
clemenceau	clemenceau
clement	clement
clements	clements
clerk	clerk
cleveland	cleveland
click	click
cliff	cliff
clifford	clifford
clijsters	clijsters
climate	climate
clint	clint
clinton	clinton
clive	clive
clooney	clooney
close	close
clover	clover
club	club
clube	clube
cluster	klaster
coast	coast
cobain	cobain
cobra	cobra
cobra	kobra
coburn	coburn
coca-cola	coca-cola
cochran	cochran
cocker	cocker
coco	coco
cocteau	cocteau
coelho	coelho
cohen	cohen
coil	coil
colbert	colbert
colby	colby
cole	cole
coleman	coleman
colette	colette
colfer	colfer
colin	colin
coliseum	coliseum
collection	collection
collège	collège
college	kolledž
colonia	koloonia
colorado	colorado
color	color
colts	colts
columbia	columbia
columbian	columbia
columbinen	columbine'i
comeback	comeback
come	come
comedy	comedy
comenius	komenský
comet	comet
comets	comets
comics	comics
commander	komandör
commedia	commedia
commodore	commodore
common	common
communications	communications
community	community
company	company
compton	compton
comptonin	comptoni
computer	computer
comte	comte
conan	conan
concacaf	concacaf
concepción	concepción
concerning	concerning
concert	concert
concerto	concerto
concordia	concordia
condé	condé
condor	condor
conley	conley
connecticutin	connecticuti
connelly	connelly
connery	connery
connolly	connolly
connor	connor
conrad	conrad
consortium	consortium
constable	constable
constant	constant
constantin	constantin
constantius	constantius
construction	construction
contador	contador
conte	conte
continental	continental
conway	conway
cook	cook
cookinsaarten	cooki
cool	cool
coolidge	coolidge
coop	coop
cooperin	cooperi
copa	copa
copenhagen	copenhagen
coppola	coppola
corazon	corazon
corbett	corbett
corbusier	corbusier
córdoba	córdoba
córdoban	córdoba
core	core
corey	corey
cork	cork
corkin	corki
cornelia	cornelia
cornelius	cornelius
cornellin	cornelli
coronation	coronation
corporation	corporation
corpse	corpse
corpus	corpus
correa	correa
corso	corso
cortés	cortés
cortina	cortina
coruña	coruña
corvette	corvette
cory	cory
così	così
cosimo	cosimo
cosmos	cosmos
costa	costa
costello	costello
coulter	coulter
coulthard	coulthard
count	count
county	county
courbet	courbet
courier	courier
course	course
courtney	courtney
coventry	coventry
coverdale	coverdale
cowboys	cowboys
cowell	cowell
crassus	crassus
crater	crater
crawford	crawford
creative	creative
creedence	creedence
crespo	crespo
creutz	creutz
crime	crime
crimson	crimson
crispin	crispin
criss	criss
cristian	cristian
cristiano	cristiano
cristóbal	cristóbal
croce	croce
croft	croft
crohnin	crohni
cromwell	cromwell
cronin	cronin
crookin	crooki
crosby	crosby
cross	cross
crow	crow
crowe	crowe
crowley	crowley
cruijff	cruijff
cruise	cruise
cruises	cruises
crush	crush
crusoe	crusoe
cruz	cruz
cruz	cruzi
cruzin	cruzi
crystal	crystal
cuba	cuba
cuban	cuban
cube	cube
cult	cult
cummings	cummings
cunard	cunard
cunningham	cunningham
cure	cure
curie	curie
current	current
curry	curry
curtis	curtis
curtiss	curtiss
curtius	curtius
cusack	cusack
cuthbert	cuthbert
cuts	cuts
cymru	cymru
cynthia	cynthia
cyrus	cyrus
dachaun	dachau
dacia	dacia
daft	daft
dagbladet	dagbladet
dagestanin	dagestani
dahlberg	dahlberg
dahl	dahl
daimler	daimler
daisuke	daisuke
daisy	daisy
dakota	dakota
dale	dale
daley	daley
dalí	dalí
dallas	dallas
dalmatialaista	dalmaatslast
dalton	dalton
daltonin	daltoni
damen	dame'i
damian	damian
damien	damien
damme	damme
damn	damn
damon	damon
dana	dana
danderydin	danderydi
dane	dane
dani	dani
daniela	daniela
daniel	daniel
daniele	daniele
danielle	danielle
danielsson	danielsson
daniil	daniil
danilo	danilo
danny	danny
danske	danske
dante	dante
danzigin	danzigi
daphne	daphne
dare	dare
dareios	dareios
darin	dari
darius	darius
dark	dark
darmstadtin	darmstadti
daron	daron
darrell	darrell
darth	darth
dartmouth	dartmouth
darwin	darwin
daryl	daryl
dave	dave
davenport	davenport
david	david
davidson	davidson
davies	davies
davis	davis
davison	davison
davit	davith
davy	davy
dawkins	dawkins
dawn	dawn
dawson	dawson
day’s	day's
days	days
dc-3	dc-3
deacon	deacon
dean	dean
death	death
debbie	debbie
debra	debra
debussy	debussy
deck	deck
decker	decker
deco	déco
de’	de'
deep	deep
deer	deer
definitely	definitely
defoe	defoe
degas	degas
degeneres	degeneres
degli	degli
dekker	dekker
deklinaatio	deklinatsioon
delacroix	delacroix
delawaren	delaware'i
deleuze	deleuze
delfiini	delfiin
delfiinit	delfiin
delfoin	delfi
delgado	delgado
delhi	delhi
delirium	delirium
della	della
dell	dell
delle	delle
dementjeva	dementjeva
demetrios	demetrios
demi	demi
demjanskin	demjanski
demokraattinen	demokraatlik
demokraattisen	demokraatliku
demokratia	demokraatia
dempsey	dempsey
dench	dench
denethor	denethor
deng	deng
denis	denis
denise	denise
dennett	dennett
dennis	dénes
dennis	dennis
denton	denton
denver	denver
depeche	depeche
deportivo	deportivo
depp	depp
derbentin	derbenti
derbyn	derby
derek	derek
derrick	derrick
derrida	derrida
descartes	descartes
deschamps	deschamps
deschanel	deschanel
desire	desire
desmond	desmond
destruction	destruction
detroit	detroit
deus	deus
deux	deux
devil	devil
deville	deville
dewey	dewey
dexter	dexter
dexterin	dexteri
dfds	dfds
dhabi	dhabi
dharma	dharma
diablo	diablo
dialogues	dialoogi
diamond	diamond
diamonds	diamonds
diana	diana
diane	diane
diary	diary
dias	dias
diaz	diaz
díaz	díaz
dicaprio	dicaprio
dickens	dickens
dickinson	dickinson
dickson	dickson
diderot	diderot
didier	didier
didius	didius
didrik	didrik
diego	diego
dies	dies
diesel	diesel
dieter	dieter
dietrich	dietrich
digitaalinen	digitaalsignaali
digital	digital
diktatuuri	diktatuur
diktonius	diktonius
dilemma	dilemma
dillinger	dillinger
dillon	dillon
dima	dima
dimebag	dimebag
dimitri	dimitri
dimmu	dimmu
dina	dina
dinara	dinara
dino	dino
diogenes	diogenes
dion	dion
dionysios	dionysios
dionysios	dionysius
dirac	dirac
diracin	diraci
direction	direction
director	director
dire	dire
dirk	dirk
dirty	dirty
disco	disco
disjunktio	disjunktsioon
disko	disko
diskografia	diskograafia
diskreetti	diskreetne
disney	disney
disneyland	disneyland
district	district
division	division
división	división
divisioona	division
dixie	dixie
dizzy	dizzy
django	django
djiboutin	djibouti
djurgårdens	djurgårdens
dmitri	dmitri
doctor	doctor
document	dokumendi
dodge	dodge
dogg	dogg
đoković	đoković
dolby	dolby
dollari	dollar
dolls	dolls
domain	omand
dome	dome
domenico	domenico
domingo	domingo
dominican	dominica
dominic	dominic
dominikaaninen	dominikaani
dominikaanisen	dominikaani
dominika	dominika
dominik	dominik
dominique	dominique
domino	domino
donatello	donatello
donato	donato
donetskin	donetski
donington	donington
donna	donna
donner	donner
donnie	donnie
donny	donny
donovan	donovan
donskoi	donskoi
don’t	don't
doom	doom
door	door
doran	doran
dorian	dorian
doris	doris
dorothea	dorothea
dorothy	dorothy
dorsetin	dorseti
dostojevski	dostojevski
doubt	doubt
doug	doug
douglas	douglas
douglass	douglass
dove	dove
downey	downey
downin	downi
downing	downing
doyle	doyle
draco	draco
dragan	dragan
drag	drag
dragon	dragon
dragons	dragons
drake	drake
drang	drang
dream	dream
dreaming	dreaming
dresdenin	dresdeni
drew	drew
drexler	drexler
dreyfus	dreyfus
drive	drive
driver	driver
drucker	drucker
dualismi	dualism
duane	duane
duarte	duarte
dubain	dubai
dubček	dubček
dublinin	dublini
ducks	ducks
dudley	dudley
duff	duff
duke	duke
dulles	dulles
dumas	dumas
dumbledore	dumbledore
dumont	dumont
duncan	duncan
dungeons	dungeons
dunn	dunn
dunne	dunne
duran	duran
durant	durant
durch	durch
dürer	dürer
durhamin	durhami
dušan	dušan
düsseldorf	düsseldorf
dust	dust
dustin	dustin
dutch	dutch
duty	duty
duval	duval
dvořák	dvořák
dwayne	dwayne
dwight	dwight
dying	dying
dyke	dyke
dylan	dylan
dyson	dyson
eagle	eagle
eagles	eagles
earl	earl
earth	earth
east	east
eastman	eastman
eastwood	eastwood
easy	easy
eaton	eaton
ebba	ebba
ebert	ebert
ecclestone	ecclestone
eckerö	eckerö
eclipse	eclipse
école	école
economist	economist
ecstasy	ecstasy
ecuadorin	ecuadori
eddie	eddie
edelfelt	edelfelt
eden	eden
eder	eder
edgar	edgar
edge	edge
edie	edie
edinburghin	edinburghi
edin	edin
edison	edison
edita	edita
edit	edit
edith	edith
édith	édith
edmond	edmond
edmonton	edmonton
edmund	edmund
edna	edna
edoardo	edoardo
édouard	édouard
eduard	eduard
eduardo	eduardo
edustaja	esindaja
edvard	edvard
edvard	edward
edvin	edvin
edward	edward
edwardin	edwardi
edwards	edwards
edwardsin	edwardsi
edwin	edwin
eedenin	eedeni
eemeli	eemeli
eeppinen	eepiline
eerik	eerik
eerik	erik
eero	eero
eeva	eeva
efektiivinen	efektiivne
effect	effect
efraim	efraim
efraim	efrayim
egil	egil
egon	egon
egyptin	egiptuse
ehrenström	ehrenström
ehud	ehud
eichmann	eichmann
”ei	”ei
eiffel	eiffel
eila	eila
eileen	eileen
einar	einar
eino	eino
einojuhani	einojuhani
einstein	einstein
einstein	einsteini
eintracht	eintracht
eirik	eirik
eisenhower	eisenhower
eisenhowerin	eisenhoweri
eisenstein	eisenstein
ekberg	ekberg
ekelund	ekelund
ekholm	ekholm
ekman	ekman
ekmanin	ekmani
ekologia	tööstusökoloogia
ekologinen	ökoloogiline
ekspressionismi	ekspressionism
ekström	ekström
ekumeeninen	oikumeeniline
elä	ela
elävä	elav
eleanor	eleanor
electra	electra
electric	electric
elefantti	elevant
elegans	elegans
elektrofiilinen	elektrofiilne
elektroniikka	elektroonika
elektroninen	elektrooniline
element	element
elena	élena
eleonoora	eleonora
eleonora	eleonora
elgar	elgar
elias	elias
elie	elie
eliel	eliel
elijah	elijah
elina	elina
elinan	elina
elin	elin
elin	elund
elinor	elinor
eliot	eliot
elisabet	elizabeth
elisabeth	elisabeth
elisabetin	eliisabeti
elisabetin	elizabethi
elis	elis
elizabeth	elizabeth
ella	ella
ellen	ellen
eller	eller
ellie	ellie
elliot	elliot
elliott	elliott
elliptinen	elliptiline
ellis	ellis
ellison	ellison
elmer	elmer
elmo	elmo
elokuva-akatemia	filmiakadeemia
elomaa	elomaa
elon	elon
elovaara	elovaara
elsa	elsa
else	else
elsi	elsi
elton	elton
elvi	elvi
elvira	elvira
elvis	elvis
emäntä	emand
emanuel	emanuel
emanuel	emanuele
embraer	embraer
’em	'em
emerson	emerson
emile	emile
émile	émile
emil	emil
emilia	emilia
emilian	emilia
emilio	emilio
emily	emily
emirates	emirates
emma	emma
emmanuel	emmanuel
emmanuelle	emmanuelle
emmy	emmy
emmylou	emmylou
emperor	emperor
empires	empires
empirismi	positivism
enckell	enckell
encyclopedia	encyclopedia
ende	ende
endre	endre
ends	ends
enemy	enemy
energia	energia
energia	tumeenergia
energia	vabaenergia
energy	energy
engberg	engberg
engelbert	engelbert
engelbrekt	engelbrekt
engel	engel
engels	engels
engine	engine
england	england
englanninkielinen	ingliskeelne
english	english
englund	englund
enix	enix
enjoy	enjoy
enkeli	ingel
enkelten	inglite
ennio	ennio
enola	enola
enonkosken	enonkoski
enqvist	enqvist
enrico	enrico
enrique	enrique
ensimmäinen	esimene
ensimmäisen	esimese
entisistä	endiste
entsiklopedija	entsüklopeedia
enver	enver
environment	environment
enzo	enzo
epäorgaaninen	anorgaaniline
ephraim	ephraim
ep-levy	play
eppu	eppu
epstein	epstein
erasmus	erasmus
erectus	erectus
eremenko	eremenko
eric	eric
éric	éric
erich	erich
ericson	ericson
ericsson	ericsson
erika	erika
erik	erik
eriksen	eriksen
erikson	erikson
erin	erin
eritrean	eritrea
erkki	erkki
erkko	erkko
erling	erling
erna	erna
ernest	ernest
ernesto	ernesto
ernst	ernst
eronen	eronen
eros	eros
erotus	eraldus
errol	errol
ervast	ervast
esaias	esaias
esa-pekka	esa-pekka
escape	escape
eskelinen	eskelinen
eskilstunan	eskilstuna
esko	esko
españa	españa
espanjan	hispaania
esperanto	esperanto
esplanadin	esplanaadi
espoon	espoo
essayah	essayah
essay	essay
essen	essen
estadio	estadio
estado	estado
estate	estate
esteban	esteban
estelle	estelle
ester	ester
estonia	estonia
estonian	estonian
estrada	estrada
etelä-afrikan	lõuna-aafrika
etelä-amerikan	lõuna-ameerika
etelä-georgian	lõuna-georgia
etelä-kalifornian	lõuna-california
etelä-kiinan	lõuna-hiina
etelä-korean	lõuna-korea
etelä-sudanin	lõuna-sudaani
etelä-suomen	lõuna-soome
etelä-walesin	uus-lõuna-walesi
ethan	ethan
ethelred	ethelred
étienne	étienne
etiikka	eetika
etiopian	etioopia
etninen	etniline
etta	etta
etuliite	detsimaaleesliited
eugene	eugene
eugène	eugène
eugen	eugen
eugénie	eugénie
eugenio	eugenio
eugenius	eugenius
eukleides	eukleides
euklidinen	eukleidese
euklidinen	eukleidiline
euler	euler
eulerin	euleri
eumenes	eumenes
euraasian	euraasia
euroopan	euroopa
europa	europe
european	european
europe	europe
eurovision	eurovisiooni
eusebios	eusebios
evakuointi	evakueerumine
evald	evald
evancho	evancho
evander	evander
evan	evan
evankeliumi	evangeelium
evans	evans
evelyn	evelyn
evening	evening
everly	everly
evert	evert
everton	everton
evil	evil
ewan	ewan
executive	executive
existence	existence
experience	experience
explorer	explorer
express	express
eyes	eyes
ezekiel	ezekiel
ezra	ezra
f-15	f-15
faber	faber
fabian	fabian
fabio	fabio
fabius	fabius
face	face
facto	facto
factor	factor
fagerholm	fagerholm
fairbanks	fairbanks
fairchild	fairchild
fair	fair
fairytale	fairytale
faisal	fayşal
falcao	falcao
falcon	falcon
falk	falk
falklandin	falklandi
falla	falla
fallon	fallon
falls	falls
falun	falun
falunin	faluni
fame	fame
familjebok	familjebok
fangio	fangio
fanning	fanning
fanny	fanny
fantasia	fantaasia
fantastinen	fantastiline
fantasy	fantasy
faradayn	faraday
farah	farah
faris	faris
farkas	farkas
farmer	farmer
farrell	farrell
färsaaret	saared
fason	faso
fassbinder	fassbinder
fast	fast
fatale	fatale
fate	fate
fatiman	fátima
fats	fats
faulkner	faulkner
faye	faye
fazer	fazer
federaation	föderatsiooni
federal	federal
federation	tenniseföderatsioon
federer	federer
federico	federico
feel	feel
feeniksin	fööniksi
felicity	felicity
feliks	feliks
felipe	felipe
félix	félix
fellini	fellini
feministinen	feministlik
femme	femme
fender	fender
fenerbahçe	fenerbahçe
feng	feng
fennica	fennica
ferdinand	ferdinand
ferenc	ferenc
ferguson	ferguson
fergusonin	fergusoni
fermat’n	fermat'
fermi	fermi
fernandes	fernandes
fernándezin	fernándeze
fernando	fernando
fernão	fernão
ferraran	ferrara
ferrari	ferrari
ferreira	ferreira
ferrer	ferrer
ferruccio	ferruccio
ferry	ferry
festival	festival
feuerbach	feuerbach
fever	fever
feynmanin	feynmani
fianna	fianna
fiat	fiat
fiction	fiction
fidžin	fidži
field	field
fields	fields
fieldsin	fieldsi
fiennes	fiennes
fifa	fifa
fifth	fifth
figaro	figaro
figaron	figaro
fighters	fighters
fighting	fighting
filharmonikot	filharmoonikud
filipe	filipe
filip	felipe
filip	filip
filip	philippe
filippo	filippo
fillmore	fillmore
film	film
filmi	film
filologia	filoloogia
filon	philon
filosofeista	filosoofide
filosofia	filosoofia
filosofiasta	filosoofiast
final	final
financial	financial
finger	finger
finland	finland
finlandia	finlandia
finnairin	finnairi
finncomm	finncomm
finn	finn
fiona	fiona
firearms	firearms
fire	fire
firefox	firefox
firenze	firenze
firenzen	firenze
first	first
firth	firth
fischer	fischer
fisher	fisher
fish	fish
fisichella	fisichella
fitch	fitch
fitzgerald	fitzgerald
fitzroy	fitzroy
five	five
fjodor	fjodor
flags	flags
flanagan	flanagan
flanderin	flaami
flanderin	flandria
flanders	flanders
flash	flash
flavia	flavia
fleet	fleet
fleetwood	fleetwood
fleischer	fleischer
fleming	fleming
fletcher	fletcher
flex	flex
flight	flight
flora	flora
florence	florence
florida	florida
floyd	floyd
flyers	flyers
flynnin	flynni
focke-wulf	focke-wulf
focus	focus
foinikian	foiniikia
folk	folk
fonda	fonda
fonseca	fonseca
fontaine	fontaine
fontana	fontana
football	football
foot	foot
forbes	forbes
ford	ford
forest	forest
forever	forever
forlán	forlán
formaali	formaalne
forman	forman
format	format
formula	vormel
forrester	forrester
forrest	forrest
forsberg	forsberg
forsius	forsius
forssell	forssell
forster	forster
fort	fort
forth	forthi
fortress	fortress
fortuna	fortuna
forum	foorum
fosfori	fosfor
fossiili	fossiil
foster	foster
foucault	foucault
foundation	foundation
four	four
fournier	fournier
fowler	fowler
foxx	foxx
frame	frame
franca	franca
france	france
francesca	francesca
francesco	francesco
franc	franc
francine	francine
franciscus	franciscus
francis	francis
franck	franck
franco	franco
françoise	françoise
françois	françois
fran	fran
frangén	frangén
franjo	franjo
frankenstein	frankenstein
frankensteinin	frankensteini
frank	frank
frankfurter	frankfurter
frankfurt	frankfurt
frankfurtin	frankfurdi
frankie	frankie
frankin	franki
frankkien	frangi
franklin	franklin
franklinin	franklini
frantz	frantz
franzén	franzén
franz	franz
franziska	franziska
frau	frau
frazier	frazier
freddie	freddie
freddy	freddy
frederic	frederic
frédéric	frédéric
frederick	frederick
frederik	frederik
fred	fred
fredric	fredric
fredrika	fredrika
fredrik	frederik
fredrik	fredrik
fredrik	friedrich
fredriksson	fredriksson
freedom	freedom
free	free
freeman	freeman
frege	frege
freiburgin	freiburgi
frei	frei
freitas	freitas
french	french
freud	freud
freund	freund
frey	frey
frick	frick
frida	frida
fridtjof	fridtjof
fried	fried
friedman	friedman
friedrich	friedrich
friends	friends
fries	fries
friis	friis
friisin	friisi
friman	friman
fripp	fripp
frisch	frisch
fritz	fritz
frodo	frodo
fromm	fromm
frosterus	frosterus
frunzen	frunze-nimeline
frusciante	frusciante
fuck	fuck
fuentes	fuentes
fujimori	fujimori
fujitsu	fujitsu
fukuokan	fukuoka
fukushima	fukushima
fukushiman	fukushima
fulgencio	fulgencio
fulham	fulham
full	full
funeral	funeral
funk	funk
funktio	funktsioon
funktionaalinen	funktsionaalne
für	für
fury	fury
futebol	futebol
fysiikanpalkinto	füüsikaauhind
fysiikka	füüsika
fysikaalinen	füüsikaline
fysiologia	füsioloogia
fysiologian	füsioloogia-
fysiologinen	füsioloogiline
gabe	gabe
gábor	gabor
gabor	gábor
gábor	gábor
gabriela	gabriela
gabriele	gabriele
gabriel	gabriel
gabriella	gabriella
gadolin	gadolin
gaël	gaël
gaetano	gaetano
gaga	gaga
gagan	gaga
gagarin	gagarin
gage	gage
gail	gail
gaiman	gaiman
gaius	gaius
galactica	galactica
gala	gala
galaksi	galaktika
galaxy	galaxy
galician	galeegi
galilei	galilei
galilein	galilei
galileo	galileo
galina	galina
galitsian	galiitsia-volõõnia
gallagher	gallagher
gallen	gallen
gallen-kallela	gallen-kallela
galleria	galerii
galleria	galleria
gall	gall
gallia	gallia
galloway	galloway
gallus	gallus
gama	gama
gamal	jamāl
gamba	gamba
gambian	gambia
gamecube	gamecube
game	game
games	games
gandhi	gandhi
gang	gang
gaon	gao
garage	garage
garam	garam
garbo	garbo
garcia	garcia
garcía	garcía
garde	garde
garden	garden
gard	gard
gardie	gardie
gareth	gareth
garfield	garfield
garfieldin	garfieldi
garfunkel	garfunkel
garibaldi	garibaldi
garland	garland
garnett	garnett
garri	garri
garry	garry
garth	garth
gary	gary
gaspard	gaspard
gaston	gaston
gates	gates
gattuso	gattuso
gaudí	gaudí
gauguin	gauguin
gaulle	gaulle
gaullen	gaulle'i
gauss	gauss
gaussin	gaussi
gautier	gautier
gavin	gavin
gävleborgin	gävleborgi
gävlen	gävle
gaye	gaye
gaza	gaza
gazeta	gazeta
gazette	gazette
gazprom	gazprom
gear	gear
geer	geer
gees	gees
geezer	geezer
geforce	geforce
geforce	geforce'i
geir	geir
gellar	gellar
gemini	gemini
geneettinen	geneetiline
gene	gene
general	general
genève	genève
gennadi	gennadi
gennaro	gennaro
genoa	genoa
genome	genoomi
genomi	genoom
genova	genova
genovan	genova
geoffrey	geoffrey
geofysiikan	geofüüsika
geographic	geographic
geologia	geoloogia
geologinen	geokronoloogiline
geometria	geomeetria
geometrinen	geomeetriline
george	george
georges	georges
georg	georg
georgian	gruusia
georgi	georgi
geórgios	geórgios
gerald	gerald
geraldine	geraldine
geraldo	geraldo
gerard	gerard
gérard	gérard
gerardo	gerardo
gerda	gerda
gerd	gerd
gerhard	gerhard
germaaninen	germaani
germaaniset	germaani
germain	germain
german	german
gerrard	gerrard
gerry	gerry
gers	gers
gershwin	gershwin
gert	gert
gertrude	gertrude
gertrud	gertrud
gesellius	gesellius
getafe	getafe
getty	getty
gettysburgin	gettysburgi
géza	géza
gezelius	gezelius
ghanan	ghana
gheorghe	gheorghe
ghost	ghost
giacomo	giacomo
giancarlo	giancarlo
gianfranco	gianfranco
gian	gian
gianluca	gianluca
gianluigi	gianluigi
gianni	gianni
giant	giant
giants	giants
gibb	gibb
gibbons	gibbons
gibbs	gibbs
gibbsin	gibbsi
gibraltarin	gibraltari
gibson	gibson
gibsonin	gibsoni
gift	gift
gifun	gifu
gigli	gigli
gijón	gijón
gilbert	gilbert
gilberto	gilberto
gilles	gilles
gillespie	gillespie
gillian	gillian
gillies	gillies
gilmoren	gilmore'i
gimli	gimli
gina	gina
ginger	ginger
ginzburg	ginzburg
giordano	giordano
giorgi	giorgi
giorgio	giorgio
giovanni	giovanni
girlfriend	girlfriend
girl	girl
girls	girls
girolamo	girolamo
giscard	giscard
giulia	giulia
giuliani	giuliani
giuliano	giuliano
giulio	giulio
given	given
gizan	giza
gladiaattori	gladiaator
gladstone	gladstone
glam	glam
glasgow’n	glasgow'
glass	glass
glen	glen
glenn	glenn
gliese	gliese
global	global
glock	glock
gloria	gloria
glory	glory
gloucesterin	gloucesteri
glover	glover
gnaeus	gnaeus
godard	godard
gödel	gödel
godenhjelm	godenhjelm
gods	gods
goebbels	goebbels
goes	goes
goethe	goethe
goff	goff
gogh	gogh
gogol	gogol
golanin	golani
golda	golda
goldberg	goldberg
goldfinger	goldfinger
gold	gold
goldman	goldman
goldsmith	goldsmith
golf	golf
golgin	golgi
golitsyn	golitsõn
gomes	gomes
gomez	gomez
gong	gong
gonna	gonna
gonzalez	gonzalez
gonzález	gonzález
gonzalo	gonzalo
goodbye	goodbye
good	good
goodman	goodman
google	google
goose	goose
gora	gora
goran	gora
goran	goran
göran	göran
gorbatšov	gorbatšov
gordianus	gordianus
gordie	gordie
gordon	gordon
gore	gore
göring	göring
gorki	gorki
gosling	gosling
gösta	gösta
göteborgin	göteborgi
gotiikan	gooti
gottfried	gottfried
gott	gott
gotthardin	gotthardi
göttingenin	göttingeni
gottlieb	gottlieb
gottlob	gottlob
gould	gould
goulding	goulding
goya	goya
graafinen	graafiline
grace	grace
graf	graf
graham	graham
grammar	grammar
granada	granada
grande	grande
grand	grand
grange	grange
granger	granger
gran	gran
granlund	granlund
granö	granö
grant	grant
grantin	granti
grass	grass
grassi	grassi
grave	grave
graves	graves
gravity	gravitatsioon
gravity	gravity
gray	gray
grayn	gray
grazin	grazi
greatest	greatest
great	great
greco	greco
greenberg	greenberg
greene	greene
green	green
greer	greer
gregg	gregg
greg	greg
gregor	gregor
gregoriaaninen	gregoriuse
gregorio	gregorio
gregorios	gregorios
gregorius	gregorius
gregory	gregory
greifswaldin	greifswaldi
grenadan	grenada
grenoble	grenoble
grete	grete
gretzky	gretzky
grey	grey
grieg	grieg
griffin	griffin
griffith	griffith
griffiths	griffiths
griffon	griffon
grigor	grigor
grigori	grigori
grimm	grimm
gripen	gripen
gris	gris
groening	groening
grohl	grohl
grönholm	grönholm
groningen	groningen
groningenin	groningeni
grönlannin	grööni
groop	groop
grosjean	grosjean
grosseton	grosseto
gross	gross
ground	ground
group	group
grover	grover
gruber	gruber
grumman	grumman
guadalajara	guadalajara
guamin	guami
guardian	guardian
guardians	guardians
guardiola	guardiola
guatemalan	guatemala
guayana	guajaana
guayanan	guajaana
guderian	guderian
gudrun	gudrun
guerre	guerre
guerrero	guerrero
guetta	guetta
guevara	guevara
guglielmo	guglielmo
guild	gildi
guillaume	guillaume
guillermo	guillermo
guinea-bissaun	guinea-bissau
guinean	guinea
guinness	guinnessi
guitar	guitar
guitars	guitars
gulliverin	gulliveri
gump	gump
gunilla	gunilla
gunnar	gunnar
guns	guns
günter	günter
günther	günther
gurdjieff	gurdžijev
guru	guru
gustaf	gustaf
gustafsson	gustafsson
gustave	gustave
gustavo	gustavo
gutenberg	gutenberg
gutiérrez	gutiérrez
guus	guus
guyana	guyana
guyanan	guyana
gwen	gwen
gyllenhaal	gyllenhaal
gynt	gynt
györgy	györgy
gyula	gyula
haag	haag
haagin	haagi
haakon	håkon
haanpää	haanpää
haapaniemen	haapaniemi
haaparannan	haparanda
haapasalo	haapasalo
haapoja	haapoja
haarla	haarla
haas	haas
haavikko	haavikko
haavisto	haavisto
haavoittunut	haavatud
haber	haber
habermas	habermas
habib	habib
habib	ḩabīb
habsburg	habsburg
habsburgien	habsburgide
hackett	hackett
hackman	hackman
hadrianus	hadrianus
hagar	hagar
hagen	hagen
haggard	haggard
hägg	hägg
hägglund	hägglund
hagia	hagia
haglund	haglund
hagman	hagman
hagrid	hagrid
hahn	hahn
haider	haider
haifan	haifa
haig	haig
haile	haile
hail	hail
haitin	haiti
hajoaminen	kahanemine
haka	haka
häkämies	häkämies
hakan	hakan
håkan	håkan
hakaniemen	hakaniemi
häkkinen	häkkinen
häkli	häkli
hakulinen	hakulinen
halen	halen
haley	haley
half	half
half-life	half-life
halford	halford
halkola	halkola
halla-aho	halla-aho
hallandin	hallandi
halle	halle
haller	haller
halleyn	halley
hall	hall
hallituksen	valitsuse
hallitus	valitsus
halliwell	halliwell
halmstadin	halmstadi
halonen	halonen
haloo	haloo
hämäläinen	hämäläinen
hamburger	hamburger
hämeen-anttila	hämeen-anttila
hamid	hamid
hamid	hāmid
hamid	ḩāmid
hamill	hamill
hamilton	hamilton
haminan	hamina
hammadin	hammadi
hammarskjöld	hammarskjöld
hammer	hammer
hammersmith	hammersmith
hammett	hammett
hamm	hamm
hammond	hammond
hammurabin	hammurapi
hampaiden	hammaste
hampshire	hampshire
hampurin	hamburgi
hancock	hancock
händel	händel
hank	hank
hanks	hanks
hanna	hanna
hannah	hannah
hannes	hannes
hannibal	hannibal
hanni	hanni
hänninen	hänninen
hannover	hannover
hannoverin	hannoveri
hannu	hannu
hannu-pekka	hannu-pekka
hanoi	hanoi
hans-georg	hans-georg
hans	hans
hanski	hanski
hansson	hansson
hanty-mansijskin	hantõ-mansiiski
happo	hape
harald	harald
harbor	harbor
harboriin	harborile
harcourt	harcourt
hardcore	hardcore
harding	harding
hardwick	hardwick
hardy	hardy
hare	hare
hari	hari
härjedalenin	härjedaleni
harjun	harju
harkovan	harkivi
harkovan	harkovi
harland	harland
harlem	harlem
harley	harley
harlin	harlin
harlow	harlow
harmon	harmon
harmonia	harmoonia
harmoninen	harmooniline
harmony	harmony
harold	harold
harrer	harrer
harriet	harriet
harri	harri
harris	harris
harrison	harrison
harry	harry
hart	hart
hartley	hartley
hartmann	hartmann
hartwall	hartwall
harun	hārūn
harvardin	harvardi
harvest	harvest
harvey	harvey
harvinaiset	haruldased
hasan	ḩasan
haskell	haskell
hassan	hassan
hasse	hasse
hassi	hassi
hastings	hastings
hatcher	hatcher
hate	hate
hathaway	hathaway
hatsinan	gattšina
hausdorffin	hausdorffi
hausen	hausen
hautala	hautala
hautamäki	hautamäki
havaiji	hawaii
havaijin	havai
havel	havel
haven	haven
havilland	havilland
havre	havre
hawke	hawke
hawking	hawking
hawks	hawks
hawthorne	hawthorne
hayao	hayao
haydn	haydn
hayek	hayek
hayes	hayes
häyhä	häyhä
hayley	hayley
hayworth	hayworth
head	head
heard	heard
heart	heart
hearts	hearts
heat	heat
heather	heather
heath	heath
heaven	heaven
heavy	heavy
heckler	heckler
hector	hector
héctor	héctor
heep	heep
hefner	hefner
hegel	hegel
heidegger	heidegger
heide	heide
heidelbergin	heidelbergi
heidfeld	heidfeld
heidi	heidi
heights	heights
heike	heike
heikki	heikki
heikkinen	heikkinen
heil	heil
heinäluoma	heinäluoma
heine	heine
heino	heino
heinrich	heinrich
heinrichs	heinrichs
heinz	heinz
heisenberg	heisenberg
helena	helena
helene	helene
hélène	hélène
helen	helen
helenius	helenius
heli	heli
helios	helios
helismaa	helismaa
hella	hella
helle	helle
hellenistinen	hellenistlik
heller	heller
hell	hell
hellmuth	hellmuth
hellström	hellström
helminen	helminen
helms	helms
helmut	helmut
helmuth	helmuth
helsingborgin	helsingborgi
helsingin	helsingi
helsinki	helsinki
helsinki-vantaan	vantaa
helvi	helvi
hemingway	hemingway
henderson	henderson
hendricks	hendricks
hendrik	hendrik
hendrix	hendrix
hendry	hendry
henie	henie
henin	henin
henkel	henkel
henley	henley
henna	henna
henning	henning
henri	henri
henrik	heinrich
henrik	henrik
henrikin	henriku
henrikinpoika	henriksson
henrique	henrique
henry	henry
henryk	henrihh
henryk	henryk
henschel	henschel
henson	henson
hepburn	hepburn
herakleen	heraklese
herbert	herbert
hercule	hercule
herkules	herakles
herlin	herlin
herman	herman
hermione	hermione
hernández	hernández
hernando	hernando
hernán	hernán
herne	hernes
heroes	heroes
hero	hero
herrmann	herrmann
herschel	herschel
hertha	hertha
hertsegovina	hertsegoviina
herttoniemen	herttoniemi
herttua	hertsog
herttuakunta	hertsogkond
hertzberg	hertzberg
hertz	hertz
hervé	hervé
herzog	herzog
hesse	hesse
hess	hess
hess	heß
hessin	hessi
heterosyklinen	heterotsüklilised
hetfield	hetfield
hetkeä	hetke
hevonen	hobune
hewitt	hewitt
heydrich	heydrich
heyerdahl	heyerdahl
hicks	hicks
hideki	hideki
hideo	hideo
hieronymus	hieronymus
hifk	hifk
higgins	higgins
higgsin	higgsi
high	high
highway	highway
hiilidioksidin	süsinikdioksiidi
hiiri	hiir
hikaru	hikaru
hilary	hilary
hilbert	hilbert
hilda	hilda
hildebrand	hildebrand
hilde	hilde
hiljainen	vaikne
hillary	hillary
hill	hill
hillilä	hillilä
hillissä	hillis
hills	hills
hilton	hilton
himmler	himmler
hindenburg	hindenburg
hingis	hingis
hino	hino
hintikka	hintikka
hippokrateen	hippokratese
hippokrates	hippokrates
hiroshi	hiroshi
hiroshiman	hiroshima
hirvonen	hirvonen
hitchcock	hitchcock
hitler	hitler
hitomi	hitomi
hits	hits
hiukset	juuksed
hjalmar	hjalmar
hjort	hjort
hobart	hobart
hobbes	hobbes
hobby	hobby
hockey	hockey
hodorkovski	hodorkovski
hoff	hoff
hoffman	hoffman
hoffmann	hoffmann
hoffmannin	hoffmanni
hofmann	hofmann
hồ	hồ
holder	holder
hold	hold
holding	holding
holger	holger
holiday	holiday
holík	holík
holkeri	holkeri
holkerin	holkeri
hollande	hollande
holland	holland
hollannin	hollandi
hollantilainen	hollandlane
holly	holly
hollywood	hollywood
holmberg	holmberg
holmes	holmes
holmesin	holmesi
holm	holm
holmin	holmi
holst	holst
holsti	holsti
holyfield	holyfield
holy	holy
homelin	homieli
homer	homer
homo	homo
homo-	homo-
honda	honda
hondurasin	hondurase
honey	honey
hongkongin	hongkongi
honka	honka
honoré	honoré
honor	honor
honorius	honorius
hood	hood
hooker	hooker
hooper	hooper
hoover	hoover
hooverin	hooveri
hope	hope
hopkins	hopkins
hopkinsin	hopkinsi
hopper	hopper
horace	horace
horacio	horacio
horizon	horizon
hormoni	hormoon
horner	horner
hornets	hornets
horn	horn
horowitz	horowitz
horst	horst
horta	horta
horthy	horthy
hossa	hossa
hossein	hossein
hotakainen	hotakainen
hotel	hotel
hotel	hotell
hotspur	hotspur
house	hardhouse
house	house
house	kodus
houston	houston
hovind	hovind
howard	howard
howe	howe
hradec	hradec
hradecký	hrádecký
hrodnan	hrodna
hruštšov	hruštšov
huang	huang
huawei	huawei
hubble	hubble
hubblen	hubble'i
hubert	hubert
hudson	hudson
huff	huff
hugh	hugh
hugo	hugo
huhtala	huhtala
huippua	tippu
hülkenberg	hülkenberg
hullut	hullud
humala	humal
humala	humala
human	human
humanismi	humanism
humberto	humberto
humboldt	humboldt
hume	hume
humphrey	humphrey
hunter	hunter
hunt	hunt
hunting	hunting
huntington	huntington
huntsman	huntsman
huonot	huonot
huovinen	huovinen
hurley	hurley
hurt	hurt
husain	ḩusayn
husserl	husserl
hutton	hutton
huumori	huumor
huuskonen	huuskonen
huvila	villa
huxley	huxley
huygens	huygens
hvoinajan	hvoinaja
hwang	hwang
hybrid	hybrid
hyde	hyde
hydra	hüdra
hymni	hümn
hymns	hymns
hyōgon	hyōgo
hypoteesi	hüpotees
hyundai	hyundai
hyvinkään	hyvinkää
hyypiä	hyypiä
iain	iain
iberian	ibeeria
ibrahim	ibrahim
ibsen	ibsen
icarus	icarus
iceland	iceland
idealismi	idealism
identiteetti	identiteet
idiot	idiot
idol	idol
idris	idris
ieee	ieee
iggy	iggy
iglesias	iglesias
ignatius	ignatius
ignaz	ignaz
igor	igor
igorin	igori
ihmemaassa	imedemaal
ihminen	inimene
ihmisen	inimese
iiris	iiris
iivo	iivo
iker	iker
ilja	ilja
iljušin	iljušin
ilkka	ilkka
illustrated	illustrated
ilmari	ilmari
ilmastonmuutokseen	kliimamuutustega
ilmastonmuutoksen	kliimamuutuse
ilomantsin	ilomantsi
ilona	iłona
ilon	ilon
ilse	ilse
il-sung	il-sŏng
il-sungin	il-sŏngi
ilves	ilves
image	image
imatra	imatra
immanuel	immanuel
immonen	immonen
imperial	imperial
imperiumi	impeerium
imperiumin	impeeriumi
imre	imre
inari	inari
incorporated	incorporated
indeksi	indeks
indeksin	indeksi
independent	independent
independent	independent's
index	index
india	india
indiana	indiana
indianapolis	indianapolis
indian	indian
indie	indie
indira	indira
indoeurooppalaiset	indoeuroopa
indonesian	indoneesia
induktio	induktsioon
industrial	industrial
infinity	infinity
information	information
ingalls	ingalls
ingeborg	ingeborg
inge	inge
ingemar	ingemar
inger	inger
ingmar	ingmar
ingrid	ingrid
ingušian	inguši
ingvar	ingvar
inha	inga
inhimillisen	inimarengu
initiative	initsiatiiv
inkeri	ingeri
inkerin	ingeri
inkvisitio	inkvisitsioon
innocentius	innocentius
innsbruckin	innsbrucki
inon	ino
institute	institute
institute	matemaatikainstituut
institut	institut
instituutti	instituut
instruments	instruments
integrated	integrated
intel	intel
intelligence	intelligence
internacional	internacional
internationaali	internatsionaal
internationale	föderatsioon
international	international
internet	internet
interstate	interstate
investointipankki	investeerimispank
invincible	invincible
iosif	jossif
iphone	iphone
ipod	ipod
ipswich	ipswich
irae	irae
irakin	iraagi
iran	iran
irina	irina
iris	iris
irja	irja
irkutskin	irkutski
iron	iron
irons	irons
iroquois	iroquois
irving	irving
irwin	irwin
isaac	isaac
isaak	issaak
isabel	isabel
isabella	isabel
isabella	isabella
isabelle	isabelle
isac	isac
isaiah	isaiah
isä	isa
isak	isak
isänmaallisen	isamaasõja
isänmaan	isamaa
ishida	ishida
isidor	isidor
isla	isla
islamilainen	islami
islamin	islami
islam	islam
islanders	islanders
island	island
islands	islands
islannin	islandi
ismail	ismail
iso-britannia	suurbritannia
isometsä	isometsä
ison-britannian	suurbritannia
israel	iisrael
israel	israel
issa	issa
istanbulin	istanbuli
istuva	istuv
istván	istván
itä-afrikan	ida-aafrika
itä-euroopan	ida-euroopa
itä-intian	ida-india
itä	itä
itäkeskuksen	itäkeskuse
itälä	itälä
italian	itaalia
italo	italo
itämeren	läänemere
itämerensuomalaiset	läänemeresoome
itä-siperian	ida-siberi
itä-suomen	ida-soome
itä-timor	ida-timor
itä-timorin	ida-timori
itävalta-unkarin	austria-ungari
itō	itō
itse	ise
itsenäisyys	iseseisvus
iuris	iuris
ivalo	ivalo
ivana	ivana
ivan	ivan
iván	iván
ivanović	ivanović
ivanov	ivanov
ivanovon	ivanovo
ivar	ivar
ives	ives
ivica	ivica
ivor	ivor
izmir	izmir
izumi	izumi
izzy	izzy
jääkausi	jääaeg
jääkiekko	jäähoki
jääkiekkomuseo	jäähokimuuseum
jääkiekon	jäähoki
jaak	jaak
jaakko	jaakko
jaakobin	jakobi
jaakob	jaakobus
jäämeri	lõuna-jäämeri
jäämeri	põhja-jäämeri
jaana	jaana
jaan	jaan
jääpallomaajoukkue	jääpallikoondis
jääskeläinen	jääskeläinen
jäätteenmäki	jäätteenmäki
jaavan	jaava
jackie	jackie
jack	jack
jackman	jackman
jackpot	jackpot
jacksonin	jacksoni
jackson	jackson
jacob	jacob
jacobs	jacobs
jacobson	jacobson
jacopo	jacopo
jacqueline	jacqueline
jacques	jacques
jacques-louis	jacques-louis
jacques-yves	jacques-yves
jade	jade
jaden	jaden
jaeger	jaeger
jafarin	jafari
jagger	jagger
jago	jago
jaguar	jaguar
jake	jake
jakob	jakob
jakobson	jakobson
jakov	jakov
jakovlev	jakovlev
jakub	jakub
jakuuttien	jakuudi
jali	charlie
jäljillä	jäljillä
jalkapalloliitto	jalgpalliliit
jalkapallon	jalgpalli
jalkojen	jalgade
jalonen	jalonen
jaltan	jalta
jamaikan	jamaica
jamalin	jamali
jamal	jamali
james	james
jamie	jamie
jammu	jammu
jämsä	jämsä
jämtlandin	jämtlandi
jana	jana
janeiro	janeiro
jane	jane
jan-erik	jan-erik
janet	janet
janez	janez
janick	janick
jani	jani
jäniksen	jänese
jänikset	jänes
janne	janne
jansson	jansson
janukovytš	janukovõtš
janus	janus
janusz	janusz
japanese	japanese
japanin	jaapani
japaninkielinen	jaapanikeelne
japan	japan
jardin	jardin
jared	jared
jari-matti	jari-matti
järjestetty	järjestatud
jarkko	jarkko
jarmo	jarmo
jarno	jarno
jaro	jaro
jaromír	jaromír
jaroslav	jaroslav
jaroslavlin	jaroslavli
jarre	jarre
järvenpää	järvenpää
järvenpään	järvenpää
järvet	järved
järvet	järvet
järvet	järvistu
järvi	järvi
järviluoma	järviluoma
järvinen	järvinen
järvistä	järvede
jašin	jašin
jasmin	jasmin
jason	jason
jasper	jasper
jätteiden	jäätmete
jauhiainen	jauhiainen
jauhiaisen	jauhiaise
javier	javier
jawaharlal	jawaharlal
jäykkä	jäik
jazz	jazz
jean-baptiste	jean-baptiste
jean-claude	jean-claude
jean-françois	jean-françois
jean-jacques	jean-jacques
jean	jean
jean-louis	jean-louis
jean-luc	jean-luc
jean-marc	jean-marc
jean-marie	jean-marie
jean-michel	jean-michel
jean-paul	jean-paul
jean-philippe	jean-philippe
jean-pierre	jean-pierre
jeesuksen	jeesuse
jeffersonin	jeffersoni
jeffrey	jeffrey
jegor	jegor
jehovan	jehoova
jekaterina	jekaterina
jekaterinburgin	jekaterinburgi
jelena	jelena
jelizaveta	jelizaveta
jelly	jelly
jeltsin	jeltsin
jemenin	jeemeni
jenan	jena
jenkins	jenkins
jenna	jenna
jenner	jenner
jennifer	jennifer
jennings	jennings
jenny	jenny
jensen	jensen
jens	jens
jenson	jenson
jeremias	jeremias
jeremy	jeremy
jérémy	jérémy
jerevanin	jerevani
jerez	jerez
jerkins	jerkins
jermaine	jermaine
jérôme	jérôme
jersey	jersey
jerusalemin	jeruusalemma
jerzy	jerzy
jesper	jesper
jesse	jesse
jessica	jessica
jessie	jessie
jesus	jeesus
jesus	jesus
jesús	jesús
jethro	jethro
jetta	jetta
jevgeni	jevgeni
jewel	jewel
jiang	jiang
jill	jill
jiménez	jiménez
jimmy	jimmy
jiří	jiří
jitzhak	yits'ẖak
joachim	joachim
joakim	joakim
joan	joan
joão	joão
joaquim	joaquim
joaquín	joaquín
jobs	jobs
jochen	jochen
jodie	jodie
jody	jody
joel	joel
joensuu	joensuu
joensuun	joensuu
joey	joey
johanna	johanna
johanneksen	johannese
johannes	johannes
johannis	iohannis
johann	johann
johansson	johansson
john	john
johns	johns
johnson	johnson
johnstonin	johnstoni
johnston	johnston
johor	johor
johor	johori
jokelan	jokela
jokerit	jokerit
joko	joko
jolie	jolie
jonah	jonah
jonas	jonas
jonatan	jonatan
jonathan	jonathan
jone	jone
jones	jones
jong-il	chŏng-il
jong	jong
joni	joni
jönköpingin	jönköpingi
jonna	jonna
jonne	jonne
jöns	jöns
jonsson	jonsson
jönsson	jönsson
joona	joona
joonas	joonas
jooniansaarten	joonia
joosef	josef
joosuan	joosua
joplin	joplin
jordanian	jordaania
jordanin	jordani
jordi	jordi
jordin	jordin
jorge	jorge
jörgen	jörgen
jørgensen	jørgensen
jörg	jörg
jorma	jorma
jörn	jörn
jose	jose
josé	josé
josephine	josephine
joséphine	joséphine
joseph	joseph
josh	josh
joshua	joshua
josif	josif
josip	josip
joss	joss
jotuni	jotuni
jouko	jouko
joule	joule
journal	journal
jovi	jovi
jo-wilfried	jo-wilfried
joyce	joyce
józef	józef
jpeg	mjpeg
juanin	juani
juan	juan
judas	judas
judd	judd
jude	jude
judge	judge
judi	judi
judith	judith
judit	judit
judo	judo
judy	judy
jugoslavian	jugoslaavia
juha	juha
juhani	juhani
juhan	juhan
juho	juho
juice	juice
jukatanin	yucatáni
jukka	jukka
jukka-pekka	jukka-pekka
julajev	julajev
jules	jules
julia	julia
juliana	juliana
julian	julian
julián	julián
julianne	julianne
julianus	julianus
julie	julie
julien	julien
juliette	juliette
julija	julija
julio	julio
julius	julius
julma	julm
july	july
jumalainen	jumalik
jumalat	jumalad
jumbo	jumbo
jump	jump
june	june
jung	jung
junior	junior
junkers	junkers
junnila	junnila
juno	juno
juoksu	jooks
jupiler	jupiler
jupiter	jupiter
jure	iure
jürgens	jürgens
juri	juri
jussi	jussi
justice	justice
justine	justine
justinianus	justinianus
justinus	justinus
just	just
jutikkala	jutikkala
jutta	jutta
juudas	juudas
juuso	juuso
juutalaisten	juutide
juutilainen	juutilainen
juvan	juvan
jyri	jyri
jyväskylän	jyväskylä
kaanikunta	khaaniriik
kaapista	kapist
kääriäinen	kääriäinen
kaari	kaar
kaari	kaari
kaarle	karl
kaarlen	karli
kaarlo	kaarlo
kabardi-balkarian	kabardi-balkaari
kabila	kabila
kabulin	kabuli
kaczyński	kaczyński
kadonneen	kadonneen
kadonnut	kadunud
kafka	kafka
kagan	kagan
kahdeksanosainen	kaheksaosaline
kahdeksas	kaheksas
kahdentoista	kaheteistkümne
kahn	kahn
kahvi	kohv
kaia	kaia
kaija	kaija
kaiken	kõige
kaiken	kõiksuse
kaikkien	kõikide
kailas	kailas
kaisa	kaisa
kaiserslautern	kaiserslautern
kaivaminen	kaevandamine
kaivanto	kaivanto
kaivos	kaevandus
kaivos	kaeveõõs
kajo	kajo
kajsa	kajsa
käkisalmen	käkisalmi
kaksikymmentä	kakskümmend
kaksoistähti	kaksiktähed
kala	kalad
kala	lõunakala
kalasataman	kalasatama
kalela	kalela
kalenteri	kalender
kalevalainen	kalevalamõõduline
kalevalan	kalevala
kalevan	kaleva
kalevi	kalevi
kalev	kalev
kalifornia	kalifornia
kalifornian	california
kaliningradin	kaliningradi
kalininin	kalinini
kalju	kalju
kallaksen	kallase
kallas	kallas
kalle	kalle
kalliomäki	kalliomäki
kalmarin	kalmari
kalmar	kalmar
kalmisto	kalmed
kalm	kalm
kalmukian	kalmõkkia
kalpa	kalpa
kalugan	kaluga
kalydonin	kalydoni
kama	kama
kaman	kaman
kamarikuoro	kammerkoor
kambodža	kambodža
kambodžan	kambodža
kambyses	kambyses
kamenev	kamenev
kamerunin	kameruni
kami	kami
kamikaze	kamikaze
kamil	kamil
kampin	kamppi
kamtšatkan	kamtšatka
kamui	kamui
kanadan	kanada
kanagawan	kanagawa
kana	kana
kanal	kanal
kanava	kanal
kandaharin	kandahāri
kandinsky	kandinsky
kane	kane
kanen	kane'i
kanerva	kanerva
kang	kang
kankkunen	kankkunen
kansain	kansai
kansa	kansa
kansalais-	kodaniku-
kansalaisuus	kodakondsus
kansallissosialistinen	natsionaalsotsialistlik
kansallisteatteri	rahvusteater
kansanarmeija	rahvaarmee
kansan	kansan
kansankomissaarien	rahvakomissaride
kansasin	kansase
kansas	kansas
kanssa	kanssa
kant	kant
kantōn	kantō
kanye	kanye
kaplan	kaplan
kapteeni	kapten
käpylän	käpylä
karadžić	karadžić
karamzin	karamzin
kardashian	kardashian
karel	karel
karenina	karenina
karen	karen
karhu	kuldkaru
karhumäen	karhumäe
kari	kari
karin	karin
karismaattinen	karismaatiline
karita	karita
karjalainen	karjalainen
karjalais-suomalaisen	karjala-soome
karjalan	karjala
karkeakarvainen	karmikarvaline
kärki	kärki
kärkinen	kärkinen
karl-erik	karl-erik
karlheinz	karlheinz
karl	karl
karlovy	karlovy
karlskronan	karlskrona
karlsruhen	karlsruhe
karlsruher	karlsruher
karlsson	karlsson
karman	karmān
karolina	karolina
karoline	karoline
karol	karol
kärpästen	kärbeste
kärpät	kärpät
karpin	karpin
karpov	karpov
karppinen	karppinen
karrer	karrer
kartli	kharthli
karun	karun
karvonen	karvonen
karzai	karzay
kashmir	kashmir
käsi	käsi
käsikirjoitus	käsikiri
kasimir	kasimir
kasimir	kazimierz
käsipallo	käsipall
käskyä	käsku
kaspar	kaspar
kasparov	kasparov
kaste	kaste
kastilia	kastiilia
kastilian	kastiilia
kasurinen	kasurinen
kasvu	kasvamine
kasvun	kasvu
katainen	katainen
kataisen	kataineni
kataja	kadakas
katalonia	kataloonia
katalonian	kataloonia
katapultti	katapult
katariina	caterina
katariina	katariina
katariinan	ekaterina
katariinan	katariina
katarina	katarina
katedraali	katedraal
kategoria	kategoria
kate	kate
katharine	katharine
katherine	katherine
kath	kath
kathleen	kathleen
kathryn	kathryn
katie	katie
kati	kati
katja	katja
katkennut	katkenud
katolinen	katoliiklik
katolinen	katoliku
katolla	katusel
katri	katri
katrin	katrin
katson	katson
katy	katy
katz	katz
kaufman	kaufman
kauhajoen	kauhajoki
kaukasian	kaukaasia
kaukoidän	kaug-ida
kauko	kauko
kaunasin	kaunase
kaunas	kaunas
kaunotar	kaunitar
kauppa	kaubandus
kauppakeskuksen	kaupluse
kauppakeskus	kaubanduskeskus
kauppakeskus	kauppakeskus
kauppakomppania	kompanii
kauppi	kauppi
kaupunginteatteri	linnateater
kaurismäki	kaurismäki
kavanagh	kavanagh
kaverin	kaverin
kawasakin	kawasaki
kaya	kaya
kayesin	kayesi
käyminen	kääritamine
kazahstanin	kasahhi
kazakstanin	kasahstani
kazanin	kaasani
kazan	kazan
kazimierz	kazimierz
kazimir	kazimir
kazuo	kazuo
kazuya	kazuya
keane	keane
keaton	keaton
keats	keats
keijo	keijo
keino	keino
keisaria	keisrit
keisari	keiser
keisarikunta	keisririik
keisarin	keisri
keitel	keitel
keith	keith
kekkonen	kekkonen
kela	kela
keller	keller
kellogg	kellogg
kello	kell
kellot	kellukas
kelly	kelly
kelsey	kelsey
keltainen	kollane
keltaisten	kollaste
kemal	kemal
kemerovon	kemerovo
kemia	keemia
kemiallinen	keemiline
kemiallisten	keemiarelvade
kemianpalkinto	keemiaauhind
kemi	kemi
kempe	kempe
kemp	kemp
kendrick	kendrick
kenelle	kellele
kenia	keenia
kenian	keenia
kenian	kenya
kenji	kenji
kennedy	kennedy
kennedyn	kennedy
kenneth	kenneth
kenny	kenny
kenraalikuvernööri	kindralkuberneride
kentin	kenti
kent	kent
keplerin	kepleri
kepler	kepler
keramiikka	keraamika
kerenski	kerenski
kern	kern
kerr	kerr
kerry	kerry
kerryn	kerry
kersti	kersti
kerstin	kerstin
kerttu	kerttu
keski-afrikan	kesk-aafrika
keskiaika	keskaeg
keskiajan	keskaegne
keskiajan	keskaja
keskiarvo	keskmine
keski-euroopan	kesk-euroopa
keski-suomen	kesk-soome
keskiyön	kesköine
keskuskenttä	keskuskenttä
keskus	keskus
keskuskomitean	keskkomitee
keskuspankki	keskpank
keskussairaala	keskhaigla
keskusta	keskerakond
kessler	kessler
ketju	kett
ketonen	ketonen
kettu	kettu
kettunen	kettunen
kevät	kevad
kevin	kevin
keynes	keynes
keys	keys
khaled	khaled
khalid	khalid
khalifa	khalīfah
khalkedonin	kalchedoni
khmerit	khmeerid
khomeini	khomeynī
kidalin	kidali
kidd	kidd
kidman	kidman
kiefer	kiefer
kielen	keele
kielen	keelealune
kielin	kieli
kielitieteen	üldkeeleteaduse
kiel	kiel
kierkegaard	kierkegaard
kihlman	kihlman
kiinan	hiina
kiinan-japanin	hiina-jaapani
kiinassa	hiinas
kiiruna	kiruna
kiirunan	kiruna
kike	kike
kilikian	kiliikia
kilin	kili
killed	killed
killers	killers
killing	killing
kill	kill
kilmister	kilmister
kilometri	kilomeeter
kilpeläinen	kilpeläinen
kilpi	kilp
kimi	kimi
kimmel	kimmel
kimmo	kimmo
kimon	kimon
kimura	kimura
kingdom	kingdom
king	king
kingsin	kingsi
kings	kings
kingsley	kingsley
kingston	kingston
kinnunen	kinnunen
kinsey	kinsey
kioton	kyōto
kipling	kipling
kippur	kippur
kippur	kippuri
kirby	kirby
kirchhoff	kirchhoff
kirchner	kirchner
kirgisian	kõrgõzstani
kiribatin	kiribati
kiri	kiri
kirilenko	kirilenko
kirill	kirill
kirjaimisto	kiri
kirjallisuuden	kirjanduse
kirjallisuus	kirjandus
kirjallisuuspalkinto	kirjandusauhind
kirjeet	kirjad
kirjeitä	kirjad
kirje	kiri
kirjoitus	kiri
kirk	kirk
kirkko	kirik
kirkonkylä	myrskylä
kirkot	kirikud
kirovin	kirovi
kirov	kirov
kirsten	kirsten
kirsti	kirsti
kissa	kass
kiss	kiss
kittelsen	kittelsen
kitts	kitts
kitts	kittsi
kitty	kitty
kitzbühelin	kitzbüheli
kiuru	kiuru
kivessä	kivis
kivi	kivi
kivimäen	kivimäe
kivimäki	kivimäki
kiviniemen	kiviniemi
kiviniemi	kiviniemi
kjell	kjell
klaipėdan	klaipėda
klan	klan
klara	klara
klas	klas
klassillinen	klassikaline
klassinen	klassikaline
klaus	klaus
klebold	klebold
klee	klee
klein	klein
klemens	clemens
klerk	klerk
kliment	kliment
kline	kline
klinga	klinga
klubi	klubi
klusteri	klaster
klux	klux
klytško	klõtško
knicks	knicks
knight	knight
knock	knock
know	know
knox	knox
knuckles	knuckles
knud	knud
knut	knut
knuut	knud
knuut	knut
kobayashi	kobayashi
kobe	kobe
koch	koch
koeman	koeman
kognitiivinen	kognitiivne
köhler	köhler
kohl	kohl
koira	koer
koirala	koīrālā
koivisto	koivisto
koivu	koivu
koivunen	koivunen
koivuniemi	koivuniemi
koivuranta	koivuranta
koizumi	koizumi
kojima	kojima
kokkonen	kokkonen
kolbe	kolbe
kolehmainen	kolehmainen
kollektiivinen	kollektiivne
koller	koller
kolmannen	kolmanda
kolmas	kolmas
kolme	kolm
kolmen	kolme
kolmetoista	kolmteist
kolminaisuuden	kolmainu
kolmio	kolmnurk
kolmiulotteinen	kolmemõõtmeline
kölnin	kölni
köln	köln
kolo	kolo
kolossi	koloss
kolu	kolu
kolumbia	columbia
kolumbian	colombia
kolumbian	columbia
kolumbus	kolumbus
komarov	komarov
komeetta	komeet
komin	komi
komission	komisjoni
kommunismin	kommunismi
kommuuni	kommuun
komorien	komooride
komppania	kompanii
kompromissi	kompromiss
konfederaatio	konföderatsioon
konferenssi	konverents
konflikti	konflikt
kongon	kongo
kongressi	kongress
kongressin	kongressi
konkreettinen	konkreetne
konrad	konrad
konsertti	kontsert
konservatiivien	konservatiivid
konservatiivinen	konservatiivne
konservatorio	konservatoorium
konstantin	konstantin
konstantinopolin	konstantinoopoli
konstantinos	konstantinos
konstantinovitš	konstantinovitš
kontiolahden	kontiolahti
konttinen	konttinen
kontula	kontula
kontulan	kontula
kontupohjan	kontupohja
koodi	kood
kool	kool
kööpenhaminan	kopenhaageni
koota	koota
kopernikus	kopernik
koponen	koponen
köppenin	köppeni
kopra	kopra
koptin	kopti
korać	korać
korean	korea
korean	korean
korean	lõuna-korea
korhonen	korhonen
korintin	kórinthose
koripallo	korvpall
koripallomaajoukkue	korvpallikoondis
koripallon	korvpalli
koripallon	korvpallis
korkea	kõrge
koroljov	koroljov
koroma	koroma
korpela	korpela
korpi	korpi
korsikan	korsika
korson	korso
kortteli	kvartal
košicen	košice
koskela	koskela
koski	koski
kosminen	kosmiline
kosminen	kosminen
kosmodromi	kosmodroom
kosmologinen	kosmoloogiline
kosola	kosola
kosovon	kosovo
kota	kota
kotka	kotka
kotkan	kotka
kotkas	kotkas
koulu	kool
koulukuntaa	koolkonda
koulukunta	koolkond
kovács	kovács
kovalainen	kovalainen
kovaljov	kovaljov
kovuus	kõvadus
kraatteri	kraater
kraft	kraft
krakovan	krakówi
kramer	kramer
kramnik	kramnik
kranjska	kranjska
krasnodarin	krasnodari
krasnojarskin	krasnojarski
krasnyi	krasnõi
krause	krause
kravitz	kravitz
krebs	krebs
kreeta	kreeta
kreetan	kreeta
kreikan	kreeka
kreikkalainen	kreeka
kreikkalaiset	kreeklased
kreikka	vana-kreeka
kreml	kreml
kresttsyn	kresttsõ
krimin	krimmi
kripke	kripke
krishnamurti	krishnamurti
kris	kris
krisse	krisse
krista	krista
kristen	kristen
krister	krister
kristianstadin	kristianstadi
kristiina	kristiina
kristillinen	kristlik
kristilliset	kristlikud
kristina	kristina
kristin	kristin
kristofer	christoffer
kristofer	kristofer
kristoffer	christoffer
kristus	kristus
kriteerit	kriteeriumid
kritiikki	kriitika
kroatia	horvaatia
kroatian	horvaatia
krohn	krohn
krokotiili	krokodill
kronikka	kroonika
kronobergin	kronobergi
kronos	kronos
kronstadtin	kroonlinna
krueger	krueger
kruger	kruger
kruunu	kroon
krzysztof	krzysztof
kserkses	xerxes
kuban	kuban
kubica	kubica
kubrick	kubrick
kuhn	kuhn
kulosaaren	kulosaari
kultainen	kuldne
kultamitali	kuldmedal
kulttuuri	kultuur
kulttuuriperintö	kultuuripärand
kummeli	kummeli
kummelin	kummelin
kummitus	ooperikummitus
kundan	kunda
kuningas	kuningas
kuningaskunta	kuningriik
kuningatar	kuninganna
kuninkaallinen	kuninglik
kuninkaalliset	kuninglikud
kuninkaiden	kuningate
kunnas	kunnas
kuopion	kuopio
kuortti	kuortti
kupittaan	kupittaa
kuqi	kuqi
kurdistanin	kurdistani
kurenniemi	kurenniemi
kurki	kurg
kurkku	kurk
kurosawa	kurosawa
kurri	kurri
kurskin	kurski
kurssi	kursus
kurt	kurt
kustaa	gustaf
kustaa	kustaa
kusti	kusti
kutsu	kutse
kuuban	kuuba
kuuden	kuuepäevane
kuudennen	kuuenda
kuudes	kuues
kuula	kuula
kuuma	kuum
kuun	kuu
kuurinmaan	kuramaa
kuusi	kuue
kuusi	kuusi
kuusinen	kuusinen
kuutio	kuubik
kuution	kuubi
kuvaja	kuvaja
kuvalehti	kuvalehti
kuvataideakatemia	kunstiakadeemia
kuwaitin	kuveidi
kuznetsova	kuznetsova
kuznetsov	kuznetsov
kvemo	khvemo
kvitová	kvitová
kvjat	kvjat
kyle	kyle
kylie	kylie
kyllönen	kyllönen
kylmä	külm
kylmästä	käest
kymen	kymi
kymmenen	kümme
kyösti	kyösti
kypros	küpros
kyra	kyra
kyrie	kyrie
kysymykset	küsimused
kysymys	küsimus
kyyros	kyros
laaksonen	laaksonen
lääni	lään
laatta	laam
label	label
laboratorio	laboratoorium
laboratory	laboratoorium
labradorin	labradori
labrador	labrador
laden	lādin
ladies	ladies
ladislaus	ladislaus
lady	lady
laertios	laertios
lafayette	fayette
lagerlöf	lagerlöf
lagerspetz	lagerspetz
lagos	lagos
lagrange	lagrange
lagrangen	lagrange'i
lagus	lagus
laguuni	laguun
lähdekoodi	lähtekood
lahdenpohjan	lahdenpohja
läheltä	lähedal
lähi-idän	lähis-ida
lahm	lahm
lahti	laht
lahti	lahti
laika	laika
laila	laila
laitinen	laitinen
laiva	laevmatus
laivasto	laevastik
laivasto	sõjalaevastik
lajos	lajos
lajunen	lajunen
lake	lake
laken	lake'i
lakers	lakers
lakin	laki
lamar	lamar
lambertin	beeri
lambert	lambert
lamb	lamb
lamborghini	lamborghini
lämpeneminen	soojenemine
lamy	lamy
lana	lana
lance	lance
lancer	lancer
landau	landau
lander	lander
landet	landet
landis	landis
landon	landon
lane	lane
lange	lange
lang	lang
language	language
lanka	lanka
länsi-afrikan	lääne-aafrika
länsi-euroopan	lääne-euroopa
länsi	lääs
länsi-rooman	lääne-rooma
länsi-siperian	lääne-siberi
länsi-suomen	lääne-soome
länsi-ukrainan	lääne-ukraina
laosin	laose
lapin	lapi
lapin	lapin
laplacen	laplace'i
lappalainen	lappalainen
lappeenrannan	lappeenranta
lappeenranta	lappeenranta
lappi	lapimaa
lappi	lappi
lapsen	lapse
lapset	lapsed
lapsi	laps
lara	lara
largo	largo
lari	laar
lari	lari
larionov	larionov
larisa	larissa
larry	larry
larsen	larsen
larson	larson
larsson	larsson
lasinen	klaasist
lasker	lasker
lasse	lasse
lassen	lassen
lassi	lassi
lasten	laste
last	last
lászló	lászló
latinalaiset	ladina
latinan	latina
latvala	latvala
latvian	läti
lauda	lauda
lauderdale	lauderdale
laulava	laulev
laulujuhlat	üldlaulupidu
laulukilpailu	lauluvõistlus
laulukilpailussa	lauluvõistlusel
laulu	laul
laura	laura
laurel	laurel
laurence	laurence
lauren	lauren
laurie	laurie
lauri	lauri
laurin	laurentsiuse
lauristin	lauristin
lautner	lautner
lauttasaaren	lauttasaari
laval	laval
lavigne	lavigne
lavoisier	lavoisier
lavrenti	lavrenti
lavrov	lavrov
lawless	lawless
lawrence	lawrence
lawrencen	lawrence'i
layne	layne
lazar	lazar
lazarus	laatsarus
lazarus	lazarus
leaf	leaf
leafs	leafs
league	league
leander	leander
leandro	leandro
lear	lear
leary	leary
leavings	leavings
lebedev	lebedev
leblanc	leblanc
lech	lech
leclerc	leclerc
ledger	ledger
leena	leena
leevi	leevi
lefebvre	lefebvre
legacy	legacy
legend	legend
legends	legends
legio	legio
lego	lego
lehman	lehman
lehmann	lehmann
lehmät	lehmad
lehtisalo	lehtisalo
lehto	lehto
lehtomäki	lehtomäki
leiber	leiber
leibniz	leibniz
leibstandarte	leibstandarte
leidenin	leideni
leif	leif
leif	leifr
leigh	leigh
leighton	leighton
leino	leino
leinon	leino
leipzigin	leipzigi
leipzig	leipzig
leisure	leisure
leka	leka
leksandin	leksandi
lemmon	lemmon
lemmy	lemmy
lena	lena
leni	leni
leningradin	leningradi
leningrad	leningrad
leninin	lenini
lenin	lenin
lenita	lenita
lennart	lennart
lennon	lennon
lennox	lennox
lenny	lenny
leno	leno
lensi	lendas
lens	lens
lentoasema	lennujaam
lento	lend
lento-onnettomuus	lennuõnnetus
lenz	lenz
léo	léo
leonard	leonard
leonardo	leonardo
leonen	leone
leonhard	leonhard
leonidas	leonidas
leonid	leonid
leónin	leóni
leon	leon
léon	léon
león	león
león	leóni
leonora	leonora
leopardi	leopard
leopardi	leopardi
leopard	leopard
leopold	leopold
leopold	léopold
lepistö	lepistö
lepo	lepo
leppänen	leppänen
leppard	leppard
leppilampi	leppilampi
leski	lesk
leskinen	leskinen
leslie	leslie
lestat	lestat
lester	lester
leto	leto
letterman	letterman
leung	leung
levadia	levadia
levi	levi
levin	levin
levon	levon
levy	levy
lewisin	lewise
lewis	lewis
liam	liam
liana	liana
libanon	liibanon
liberaalidemokraattinen	liberaaldemokraatlik
liberal	liberaalne
liberian	libeeria
liberty	liberty
library	library
libyan	liibüa
license	litsents
lichtenstein	lichtenstein
licinius	licinius
lidingön	lidingö
liebe	liebe
liebknecht	liebknecht
liechtensteinin	liechtensteini
liègen	liège'i
life	life
liga	liga
light	light
lightning	lightning
ligue	ligue
liiga	kuldliiga
liiga	liiga
liikanen	liikanen
liike	liikumine
liina	liina
liisi	liisi
liittokansleri	liidukantsler
liitto	liit
liiviläisten	liivi
liivin	liivi
liivinmaan	liivimaa
like	like
lila	lila
lilius	lilius
lilja	lilja
lille	lille
lillian	lillian
lil’	lil'
lilli	lilli
lilly	lilly
lilo	lilo
lily	lily
lima	lima
lina	lina
lincolnin	lincolni
linda	linda
lindbergh	lindbergh
lindberg	lindberg
lindemann	lindemann
linder	linder
lindgrenin	lindgreni
lindgren	lindgren
lindin	lindi
lind	lind
lindman	lindman
lindsay	lindsay
lindsey	lindsey
lineaarinen	lineaarfunktsioon
lineaarinen	lineaarvõrrand
line	line
lines	lines
linja	liin
linkin	linkin
linkola	linkola
linkomies	linkomies
linköpingin	linköpingi
linna	linnus
linnankoski	linnankoski
linnean	linné
linné	linné
linn	linn
linnoista	linnuste
linnut	linnud
linnut	linnut
lintujen	lindude
linus	linus
linux	linux
linz	linz
lionel	lionel
lion	lion
lipas	laegas
lippi	lippi
lipponen	lipponen
lippu	lipp
lipuista	lipud
liput	lipud
lisa	lisa
lise	lise
lisp	lisp
lissabonin	lissaboni
listening	listening
list	list
liston	liston
liszt	liszt
lita	lita
literary	literary
litmanen	litmanen
little	little
litvinov	litvinov
liukas	liukas
liuzzi	liuzzi
live	live
lively	lively
liverpool	liverpool
lives	lives
livia	livia
living	living
livingstone	livingstone
livornon	livorno
liza	liza
lizzie	lizzie
ljubov	ljubov
ljubytinon	ljubõtino
ljudmila	ljudmila
ljungberg	ljungberg
lleyton	lleyton
lloyd	lloyd
lobo	lobo
locarnon	locarno
locke	locke
locke	locke'i
lockerbien	lockerbie
lockheed	lockheed
lodge	lodge
łódźin	łódźi
logaritmi	naturaallogaritm
logaritminen	logaritmiline
logiikka	loogika
lohan	lohan
lohja	lohja
loire	loire
loiri	loiri
loki	loki
lola	lola
lombardian	lombardia
lomonosovin	lomonossovi
london	london
lonely	lonely
lonesome	lonesome
longin	longi
long	long
lönnrot	lönnrot
lontoon	londoni
loose	loose
lopes	lopes
lopez	lopez
lordi	lordi
lord	lord
loren	loren
lorentzin	lorentzi
lorenz	lorenz
lorenzo	lorenzo
loretta	loretta
lori	lori
lorraine	lorraine
loser	loser
lothar	lothar
lothringenin	lotringi
lotta	lotta
lotta	lotte
lotto	lotto
lotus	lotus
louder	louder
loud	loud
louhen	louhi
louhimies	louhimies
louisa	louisa
louisin	louise
louis	louis
louvren	louvre'i
lovato	lovato
lovecraft	lovecraft
lovejoy	lovejoy
lovell	lovell
love	love
loviisan	loviisa
lowe	lowe
loyola	loyola
lublinin	lublini
luca	luca
lucasin	lucase
lucas	lucas
luce	luce
lucia	lucia
lucian	lucia
lucian	lucian
lucie	lucie
lucien	lucien
lucina	lucina
lucius	lucius
luck	luck
lucy	lucy
ludendorff	ludendorff
ludovico	ludovico
ludvig	louis
ludwig	ludwig
lufthansa	lufthansa
luigi	luigi
luisa	luisa
luise	luise
luis	luis
luís	luís
luiz	luiz
lukašenka	łukašenka
lukas	lukas
lukas	lukáš
lukáš	lukáš
luke	luke
lukin	luki
lula	lula
lumia	lumia
lumikki	lumivalgeke
lumilautailu	lumelauasõit
lumme	lumme
lumpurin	lumpuri
luna	luna
lunar	lunar
lundberg	lundberg
lund	lund
lundqvist	lundqvist
lundström	lundström
luostari	klooster
luostarinmäen	luostarinmäe
lupin	lupin
lupu	lupu
luterilainen	luteri
luterilainen	luterlik
luther	luther
luukkaan	luuka
luukkonen	luukkonen
luxemburgin	luksemburgi
luxemburg	luksemburg
lvivin	lvivi
lviv	lviv
lybeck	lybeck
lydia	lydia
lyhyeksi	lühikeseks
lyhytkarvainen	lühikarvaline
lynch	lynch
lyndon	lyndon
lynn	lynn
lynyrd	lynyrd
lyydin	lüüdi
lyyran	lüüra
maaginen	maagiline
maahockey	maahoki
maailma	ilm
maailma	maailm
maailmancup	maailma
maailmanennätykset	maailmarekordid
maailmankuva	maailmasüsteem
maailmanliitto	maailmaliit
maailman	maailma
maailmanmestaruuskilpailujen	maailmameistrivõistluste
maailmanmestaruuskilpailut	maailmameistrivõistlused
maailmannäyttely	maailmanäitus
maailmansodassa	maailmasõja
maailmansodassa	maailmasõjas
maailmansota	maailmasõda
maailman	ülemaailmne
maakunnat	maakonnad
maalle	maale
maanjäristys	maavärin
maan	maa
maarten	maarten
maastrichtin	maastrichti
määttä	määttä
maavoimat	maavägi
maavoimien	maavägede
macaon	macau
macarthur	macarthur
macarthur	macarthuri
macaulay	macaulay
machado	machado
machiavelli	machiavelli
machina	machina
machine	machine
mach	mach
macintosh	macintosh
mackay	mackay
mackenzie	mackenzie
macpherson	macpherson
macy	macy
madagaskarin	madagaskari
madden	madden
madeira	madeira
madeleine	madeleine
madhya	madhya
madisonin	madisoni
madison	madison
madonna	madonna
madrid	madrid
madrid	madridi
mads	mads
maduro	maduro
mäenpää	mäenpää
mafia	maffia
mafia	mafia
magadanin	magadani
magalhães	magalhães
magda	magda
maggie	maggie
maggio	maggio
magic	magic
magna	magna
magneettikentän	magnetvälja
magneettikenttä	magnetväli
magneettinen	magnetiline
magnetic	magnetic
magnus	magnus
magnussen	magnussen
maguire	maguire
mahal	mahal
maha	maha
mahatma	mahatma
maher	maher
mahiljoun	mahiloŭ
mahler	mahler
mahmoud	maxamuud
mahmud	maḩmūd
maia	maia
maiden	maiden
maier	maier
maili	miil
mail	mail
mainz	mainz
maire	maire
majakovski	majakovski
maja	maja
majoris	majoris
major	major
mäkäräinen	mäkäräinen
makarios	makários
makarov	makarov
makedonia	makedoonia
makedonian	makedoonia
mäkelä	mäkelä
maker	maker
makes	makes
maki	maki
mäki	mäki
mäkinen	mäkinen
makkonen	makkonen
makoto	makoto
maksimilian	maximilian
maksuton	tasuta
malaijien	malai
malaijin	malai
malaja	malaja
malakan	malaka
malakian	malakian
malawi	malaŵi
malawin	malawi
malaysia	malaysia
maldonado	maldonado
malediivien	maldiivide
malesian	malaisia
malevitš	malevitš
malfoy	malfoy
malice	malice
malick	malick
malik	malik
mali	mali
malin	mali
malkovich	malkovich
mallin	mallin
malmberg	malmberg
malmi	malmi
malminkartanon	malminkartano
malmin	malmi
malmö	malmö
malmön	malmö
malmström	malmström
malone	malone
malta	malta
maltan	malta
mamadou	mamadou
mama	mama
mamas	mamas
mamma	mamma
management	management
manchester	manchester
mancini	mancini
mandela	mandela
mandy	mandy
manet	manet
mang	mang
manhattan	manhattan
manifesti	manifest
mani	mani
manitoban	manitoba
mankell	mankell
manne	manne
mannerheimin	mannerheimi
mannerheim	mannerheim
manninen	manninen
manning	manning
mann	mann
mannola	mannola
manny	manny
manon	manon
mansell	mansell
mansfield	mansfield
mansin	mansi
mans	mans
måns	måns
manson	manson
mantegna	mantegna
mantere	mantere
mantovan	mantova
mäntylä	mäntylä
mänty	mänd
manuela	manuela
manuel	manuel
manu	manu
maorien	maoori
maple	maple
maps	maps
maradona	maradona
marat	marat
marburgin	marburgi
marcello	marcello
marcellus	marcellus
marcel	marcel
marcelo	marcelo
marc	marc
marconi	marconi
marcos	marcos
marcus	marcus
marek	marek
mare	mare
margareeta	margrete
margareeta	margrethe
margaret	margaret
margarita	margarita
marge	marge
margera	margera
margo	margo
margot	margot
mariaanien	mariaani
mariah	mariah
maria	maria
maría	maría
mariam	mariam
mariana	mariana
marian	maarja
marian	marian
marianna	marianna
mariano	mariano
marie-louise	marie-louise
marija	marija
marilyn	marilyn
marilyn	marilyniga
marina	marina
marine	marine
mariner	mariner
marinin	marini
marin	marin
marino	marino
marinon	marino
marinus	marinus
mário	mário
marion	marion
marita	marita
marit	marit
marius	marius
marja-liisa	marja-liisa
marjamäki	marjamäki
marjo	marjo
marjorie	marjorie
market	market
markiisi	markii
markkanen	markkanen
markku	markku
mark	mark
marko	marko
markovin	markovi
markov	markov
markuksen	markuse
markus	markus
marley	marley
marlon	marlon
marlowe	marlowe
marnen	marne'i
marokko	maroko
maroon	maroon
marple	marple
márquez	márquez
marr	marr
marsalkka	marssal
marsden	marsden
marseille	marseille
marshallin	maršalli
marshall	marshall
marsh	marsh
marsin	marsi
mars	mars
marssi	marss
martel	martell
martensin	martensi
martha	martha
martial	martial
martí	martí
martina	martina
martínez	martínez
martinique	martinique
martin	martin
martín	martín
martino	martino
martins	martins
martinus	martinus
mart	mart
martti	martti
marty	marty
marussia	marussia
marvin	marvin
marx	marx
marylandin	marylandi
mary	mary
masi	masi
mason	mason
massacre	massacre
massa	mass
massa	massa
mass	mass
massojen	masside
masson	masson
master	master
matala	maa-lähedane
mata	mata
matemaattinen	matemaatiline
mate	mate
matematiikka	matemaatika
materialismi	materialism
mater	mater
mathematica	mathematica
mathias	mathias
mathieu	mathieu
matilda	matilda
matilde	matilde
mato	mato
matsumoto	matsumoto
matta	matta
matteo	matteo
matter	matter
matters	matters
matteuksen	matteuse
matteus	matteus
matthau	matthau
matthew	matthew
matthias	matthias
mattias	mattias
mattila	mattila
matti	matti
matt	matt
mattsson	mattsson
maude	maude
maudin	maudi
mauna	mauna
maun	mau
mauno	mauno
maupassant	maupassant
maureen	maureen
maurer	maurer
mauricio	mauricio
mauri	mauri
mauritanian	mauritaania
mauritiuksen	mauritiuse
mauritius	mauritius
mausoleumi	mausoleum
mavericks	mavericks
maxime	maxime
maximilian	maximilian
maximilien	maximilien
maximinus	maximinus
maxwellin	maxwelli
maxwell	maxwell
maya	maya
mayday	mayday
mayer	mayer
maynard	maynard
mays	mays
mayweather	mayweather
maze	maze
mcbeal	mcbeal
mcbride	mcbride
mccain	mccain
mccandless	mccandless
mccarthy	mccarthy
mcconnell	mcconnell
mccormick	mccormick
mccoy	mccoy
mcdonald	mcdonald
mcdonnell	mcdonnell
mcdowell	mcdowell
mcgrath	mcgrath
mcgregor	mcgregor
mcguire	mcguire
mchale	mchale
mckay	mckay
mckenna	mckenna
mckenzie	mckenzie
mclaren	mclaren
mclaughlin	mclaughlin
mcneill	mcneill
mcqueen	mcqueen
mcrae	mcrae
meadows	meadows
means	means
meat	meat
medal	medal
media	media
media	meedia
media	sotsiaalmeedia
medici	medici
medium	meedium
medvedev	medvedev
meer	meer
meet	meet
meets	meets
megan	megan
mehiläinen	meemesilane
mehiläisen	mesilase
mehmed	mehmed
mehmed	mehmet
mehmet	mehmet
mehta	mehta
meilahden	meilahti
meinander	meinander
meir	meir
meir	me'ir
mekaaninen	mehaaniline
mekaniikka	mehaanika
mekan	meka
meksikon	mehhiko
mela	mela
melanie	melanie
melartin	melartin
melbourne	melbourne
melbournen	melbourne'i
melissa	melissa
mello	mello
mellon	mellon
mellunmäen	mellunmäki
melody	melody
melua	melua
members	members
memelin	memeli
memorial	memorial
memphis	memphis
mena	mena
mendel	mendel
mendelssohn	mendelssohn
mendes	mendes
menetelmä	meetod
mengele	mengele
mengistu	mengistu
menzel	menzel
mercator	mercator
mercedes-benz	mercedes-benz
mercedes-benz	mercedes-benzi
mercedes	mercedes
merchant	merchant
merck	merck
mercury	mercury
meredith	meredith
merenneito	merineitsi
meren	verine
merikanto	merikanto
merisalo	merisalo
merkel	merkel
merkki	märk
merle	merle
merritt	merritt
mersennen	mersenne'i
mertaranta	mertaranta
meryl	meryl
mesa	mesa
messenger	messenger
messerschmitt	messerschmitt
messina	messina
messinan	messina
mestarien	meistrite
mestari	meister
metafyysinen	metafüüsiline
metal	metal
method	method
metri	meeter
metrinen	meetriline
metrin	meetri
metroasema	metroojaam
metropolitan	metropolitani
metsä	mets
metsän	metsavennad
mexico	mexico
méxico	méxico
meyer	meyer
meyers	meyers
miami	miami
michaela	michaela
michael	michael
michal	michal
michał	michał
michelangelo	michelangelo
michele	michele
michèle	michèle
michelle	michelle
michel	michel
michiganin	michigani
mick	mick
microsoft	microsoft
middlesbrough	middlesbrough
midi	midi
midnight	midnight
midwayn	midway
miehittämätön	mehitamata
mielenterveys	tervis
mies	mees
mies	mies
miespääosan	meespeaosatäitja
miesten	meeste
mieto	mieto
miguel	miguel
mihail	mihhail
mihailovitš	mihhailovitš
mihai	mihai
mihály	mihály
miia	miia
miikka	miikka
miina	miina
mikael	mikael
mika	mika
mikel	mikel
mike	mike
mikheil	mihheil
mikkelin	mikkeli
mikkelsen	mikkelsen
mikki	miki
mikkonen	mikkonen
miklós	miklós
mikojan	mikojan
mikojan	mikojan-gurevitš
mikrofoni	mikrofon
mila	mila
milankovićin	milankovići
milan	milan
milano	milano
milanon	milano
mildred	mildred
mile	miili
mile	mile
miles	miles
miley	miley
miljoona	miljoona
milk	milk
millennium	millennium
miller	miller
millimetrin	5-millimeetrine
mill	mill
mills	mills
milne	milne
milner	milner
milo	milo
milonoff	milonoff
milošević	milošević
miloš	miloš
milton	milton
milwaukee	milwaukee
minaj	minaj
minä	mina
minas	minas
mind	mind
ming	ming
mingus	mingus
minh	minh
minimi	miinimum
ministeri	minister
ministerineuvosto	ministrite
ministerineuvoston	ministrite
minna	minna
minnelli	minnelli
minnesota	minnesota
minnie	minnie
minni	minni
minogue	minogue
minolainen	minose
minores	minores
minoru	minoru
minskin	minski
mint	mint
minutes	minutes
minuuttia	minutit
miracle	miracle
mirage	mirage
mircea	mircea
miriam	miriam
mirin	miri
mirjam	mirjam
mirkka	mirkka
mirko	mirko
miro	miro
miró	miró
miron	miron
mironov	mironov
miroslav	miroslav
mirren	mirren
misery	misery
mises	mises
mishima	mishima
missa	missa
mission	mission
miss	miss
missourin	missouri
mistral	mistral
mitali	medal
mitalitaulukko	medalitabel
mitchell	mitchell
mitch	mitch
mitsubishi	mitsubishi
mitterrand	mitterrand
mitt	mitt
miyamoto	miyamoto
miyazaki	miyazaki
miyazakin	miyazaki
moberg	moberg
mobile	mobile
mobilen	mobile'i
mobutu	mobutu
moby	moby
model	model
mode	mode
modenan	modena
moderna	moderna
modern	modern
modigliani	modigliani
moen	moe
moen	moen
mogadishun	muqdisho
mohamed	maxamed
mohamed	mohamed
mohamed	muḩammad
mohammad	moḩammad
mohammed	moḩammad
mohammed	mohammed
mohsin	mohsi
moines	moines
moisander	moisander
mojaven	mojave
mojo	mojo
moldavian	moldaavia
molde	molde
moldova	moldova
moldovan	moldova
molempain	mõlema
molina	molina
mollberg	mollberg
molly	molly
molotov	molotov
moltke	moltke
moment	moment
momentti	moment
monaco	monaco
monacon	monaco
monaghan	monaghan
monarkia	monarhia
monday	monday
monet	monet
mongolian	mongoolia
mongolien	mongoli
mongolien	mongolite
monica	monica
monika	monika
monismi	monism
monkey	monkey
monk	monk
monnet	monnet
mono	mono
monopoli	monopoolus
monroe	monroe
monster	monster
montana	montana
monteiro	monteiro
montell	montell
monte	monte
montenegro	montenegro
montenegron	montenegro
monteverdi	monteverdi
montgomery	montgomery
montgomeryn	montgomery
monti	monti
mont	mont
montoya	montoya
montpellier	montpellier
montrealin	montréali
montreal	montreal
montréal	montréalis
montserrat	montserrat
monument	monument
monza	monza
moody	moody
moog	moog
moonlight	moonlight
moon	moon
moorcock	moorcock
moore	moore
mooren	moore'i
mooseksen	moosese
moptin	mopti
moraalinen	universaalne
morales	morales
mora	mora
mordvan	mordva
moreau	moreau
moreira	moreira
moreno	moreno
morganin	morgani
morgan	morgan
morgenstern	morgenstern
mori	mori
morissette	morissette
morita	morita
moritz	moritz
mormonin	mormoni
mörne	mörne
morozov	morozov
morphy	morphy
morris	morris
morrison	morrison
morse	morse
mortensen	mortensen
mosambikin	mosambiigi
moser	moser
moses	moses
moshe	moshe
moskova	moskva
moskovan	moskva
mosley	mosley
moss	moss
motalan	motala
motion	stop-motion
mötley	mötley
motor	motor
motors	motors
mott	mott
möttölä	möttölä
motu	motu
moulin	moulin
mount	mount
mourinho	mourinho
mouse	mouse
moussa	moussa
move	move
movie	movie
mozart	mozart
mozilla	mozilla
mstislav	mstislav
muammar	mu‘ammar
mubarak	mubārak
much	much
muhammad	maxamed
muhammad	mohammed
muhammad	muhammad
muhammad	muḩammad
muhammed	muḩammad
muir	muir
muistopäivä	mälestuspäev
mujejärven	mujejärvi
mukdenin	mukdeni
mullan	mulla
mullen	mullen
müller	müller
mulligan	mulligan
münchenin	müncheni
munch	munch
mundi	mundi
municipal	municipal
muni	muni
munro	munro
münsterin	münsteri
murad	murad
murakami	murakami
murat	murad
murat	murat
murdoch	murdoch
muriel	muriel
murmanskin	murmanski
murphy	murphy
murray	murray
murre	murre
mursi	mursī
musa	musa
museet	museet
museossa	muuseumis
museot	muuseumid
museum	museum
museum	muuseum
museum	muuseumis
musica	musica
music	music
musiikin	muusikastiilide
musiikki-	muusika-
muskettisoturia	musketäri
mussolini	mussolini
mustafa	mustafa
mustaine	mustaine
mustan	musta
mustikka	mustikas
mustissa	mustas
mustonen	mustonen
mutanttininjakilpikonnat	ninjakilpkonnad
mutt	mutt
muumilaakson	muumioru
muumipapan	muumipapa
muuttuva	muutlik
myanmarin	myanmari
mykeneläinen	mükeene
mykkänen	mykkänen
myles	myles
myllylä	myllylä
myllypuron	myllypuro
mysterio	mysterio
mytologia	mütoloogia
myyrä	myyrä
nabokov	nabokov
nadežda	nadežda
nadežda	nadija
nadia	nadia
nadine	nadine
nadir	nādir
naganon	nagano
nagasakin	nagasaki
nagel	nagel
nail	nail
nails	nails
nainen	naine
nairobin	nairobi
naisten	naiste
nakajima	nakajima
nakamura	nakamura
naked	naked
nälänhätä	näljahäda
namibian	namiibia
namin	namtsõ
nancy	nancy
nanjingin	nanjingi
nano	nano
nansenin	nanseni
nansen	nansen
nantesin	nantes'i
nantes	nantes
naomi	naomi
naoto	naoto
napalm	napalm
napier	napier
napoleonin	napoleoni
napoleon	napoleon
napoli	napoli
napolin	napoli
naran	nara
narayan	narayan
närhi	närhi
narnian	narnia
narodnaja	narodnaja
naruto	naruto
narva	narva
narvan	narva
narvassa	narvas
nash	nash
nasr	nasr
nassaun	nassau
natalia	natalia
natalie	natalie
natalja	natalja
natasha	natasha
nate	nate
nathalie	nathalie
nathanael	nathanael
nathaniel	nathaniel
nathan	nathan
nationale	nationale
national	national
nation	nation
nations	nations
naton	nato
natsismin	natsismi
natt	natt
nature	nature
naughty	naughty
nauru	nauru
naurun	nauru
navarran	navarra
navarro	navarro
navas	navas
nazarbajev	nazarbajev
nazcan	nazca
neal	neal
néa	néa
nebukadressar	nebukadnetsar
nedvěd	nedvěd
need	need
negative	negative
negro	negro
nehru	nehru
neill	neill
neil	neil
neitsyt	neitsi
neitsytsaaret	neitsisaared
neljä	neli
neljä	neljä
neljän	nelja
neljäs	neljas
nellie	nellie
nelly	nelly
nelson	nelson
nemean	nemea
nemo	nemo
nenad	nenad
nepalin	nepali
neptunus	neptun
nero	nero
ness	ness
nestorin	nestori
nestor	nestor
néstor	néstor
netanjahu	netanyahu
neto	neto
nets	nets
network	network
neue	neue
neuhaus	neuhaus
neumann	neumann
neurath	neurath
nevada	nevada
nevala	nevala
neva	neeva
nevan	neeva
never	never
neves	neves
neville	neville
nevisin	nevise
nevis	nevis
nevski	nevski
nevskin	nevski
newcastle	newcastle
newell	newell
newfoundland	newfoundland
newman	newman
newportin	newporti
newport	newport
news	news
newtonin	newtoni
newton	newton
nexus	nexus
ngô	ngô
nguyen	nguyen
nguyễn	nguyễn
niagara	niagara
niagaran	niagara
nicaragualainen	nicaragua
nicaragua	nicaragua
nicaraguan	nicaragua
nice	nice
nicholas	nicholas
nicholls	nicholls
nichols	nichols
nicholson	nicholson
nickel	nickel
nicki	nicki
nicklas	nicklas
nick	nick
nicko	nicko
nicky	nicky
nicolae	nicolae
nicolai	nicolai
nicola	nicola
nicolas	nicolas
nicolás	nicolás
nicolaus	nicolaus
nicole	nicole
nico	nico
nielsen	nielsen
niels	niels
niemi	neem
nieminen	nieminen
niemi	niemi
nietzsche	nietzsche
nigel	nigel
nigerian	nigeeria
nigerin	nigeri
niger	niger
niger	nigeri
night	night
niiden	neid
niinistö	niinistö
nikaian	nikaia
nikean	nikaia
nike	nike
niki	niki
nikita	nikita
nikkinen	nikkinen
nikki	nikki
niklas	niclas
niklas	niklas
nikolai	nikolai
nikolajevitš	nikolajevitš
nikolajev	nikolajev
nikola	nikola
nikolaoksen	nikolause
nikólaos	nikólaos
nikolaus	mikołaj
nikolaus	nicolaus
nikomakhoksen	nikomachose
niko	niko
niku	niku
nils-aslak	nils-aslak
nilsen	nilsen
nils	nils
nilsson	nilsson
nimet	nimed
nimipäivät	nimipäivät
nina	nina
nine	nine
ninja	ninja
nino	nino
niño	niño
nintendo	nintendo
nippon	nippon
niro	niro
nishikori	nishikori
niskanen	niskanen
nissan	nissan
nixon	nixon
nižni	nižni
noah	noah
noam	noam
nobelin	nobeli
nobel	nobel
nobody	nobody
nocturnal	nocturnal
noel	noel
noetherin	noetheri
noir	noir
nokia	nokia
nolan	nolan
nono	nono
nora	nora
norbert	norbert
nordenskiöld	nordenskiöld
nordisk	nordisk
nord	nord
normaali	normaali
normaali	normaalne
normale	normale
normandian	normandia
norman	norman
norodom	norodom
norrback	norrback
norrbottenin	norrbotteni
norrköping	norrköping
norrtäljen	norrtälje
norsunluurannikon	elevandiluuranniku
norte	norte
northern	northern
north	north
northrop	northrop
northwest	northwest
norton	norton
norwegian	norwegian
norwich	norwich
note	note
notorious	notorious
notre	notre
notre	notre-dame'i
nottingham	nottingham
nousiainen	nousiainen
novaja	novaja
novak	novak
nova	nova
novello	novello
novgorodin	novgorodi
novgorod	novgorod
novikov	novikov
novi	novi
novo	novo
novosibirskin	novosibirski
novosti	novosti
novyi	novõi
nowitzki	nowitzki
nubian	nuubia
nuestra	nuestra
nueva	nueva
nuevo	nuevo
nukem	nukem
nukleofiilinen	nukleofiilne
numan	numan
number	number
numerot	numbrid
nummi	nummi
núñez	núñez
nuno	nuno
nuorempi	noorem
nuoren	noore
nuoret	noored
nuorten	noorte
nurminen	nurminen
nurmi	nurmi
nürnbergin	nürnbergi
nursultan	nursultan
nuuksion	nuuksio
nuutila	nuutila
nyheter	nyheter
nylands	nylands
nylon	nylon
nylund	nylund
nyman	nyman
nyqvist	nyqvist
oakley	oakley
oath	oath
obama	obama
obi-wan	obi-wan
objekti	objekt
o’brien	o'brien
obscura	obscura
observatorio	observatoorium
occamin	ockhami
ocean	ocean
ochoa	ochoa
o’connor	o'connor
octave	octave
octavia	octavia
october	october
odense	odense
odessan	odessa
o’donnell	o'donnell
odysseus	ulysses
odyssey	odyssey
offenbach	offenbach
office	office
ohmin	ohmi
öhquist	öhquist
oidipus	oidipus
oikeusministeri	justiitsministrite
oikeus	õigus
oikeustiede	õigusteadus
oilers	oilers
oinas	oinas
oiva	oiva
ojala	ojala
ojansuu	ojansuu
okan	oka
okavangon	okavango
okinawan	kesk-okinawa
okkonen	okkonen
oklahoma	oklahoma
oksana	oksana
oksanen	oksanen
oksidit	oksiidid
okulovkan	okulovka
olaus	olaus
olavi	olav
olavi	olavi
olav	olav
oldenburgin	oldenburgi
oldenburg	oldenburg
oldfield	oldfield
oldham	oldham
oldman	oldman
oleg	oleg
oleksandr	oleksandr
olga	olga
olhavan	volhovi
oliveira	oliveira
oliver	oliver
olivia	olivia
olivier	olivier
olkiluodon	olkiluoto
olle	olle
ollikainen	ollikainen
ollila	ollila
olli	olli
olmert	olmert
olof	olof
olov	olov
olsen	olsen
olsson	olsson
olympiakomitea	olümpiakomitee
olympiastadion	olümpiastaadion
olympic	olympic
olympus	olympus
omanin	omaani
omar	omar
omar	‘omar
omar	’omar
omega	omega
omena	omena
omskin	omski
online	online
onnen	õnne
onnettomuus	õnnetus
onni	onni
ontologinen	ontoloogiline
oopperatalo	ooperimaja
oopperatalo	ooperiteater
oortin	öpiku-oorti
opel	opel
open	open
operaatio	operatsioon
opera	opera
operations	operations
oper	oper
opettaja	õpetaja
oppenheimer	oppenheimer
oppipoika	õpipoiss
oprah	oprah
optical	optical
optinen	optilise
opus	opus
oraakkeli	oraakel
orangen	orange'i
orbison	orbison
orbiter	orbiter
ordo	ordo
örebron	örebro
oregonin	oregoni
orenburgin	orenburgi
orgaaninen	orgaaniline
organisation	organisation
organismi	organism
organization	organization
orhan	orhan
origin	origin
orjolin	orjoli
orlando	orlando
orleans	orleans
orlov	orlov
orman	orman
orpo	orpo
orrin	orrin
orson	orson
ørsted	ørsted
ortega	ortega
orvokki	orvokki
orwell	orwell
osaka	osaka
osaka	ōsaka
osakunta	osakunta
osamu	osamu
osborne	osborne
osbourne	osbourne
oscar-gaala	oscari
oscar	oscar
óscar	óscar
oscar-palkinto	oscar
osittain	osaline
oskari	oskari
oskar	oskar
oslon	oslo
osmanien	osmanite
osman	osman
osmo	osmo
ossian	ossian
osta	osta
osta	ostuvaba
östen	östen
österman	österman
östersundin	östersundi
ostoskeskus	keskus
ostrogoottien	idagootide
o’sullivan	o'sullivan
osvaldo	osvaldo
osvald	osvald
oswald	oswald
otan	otan
otepään	otepää
otis	otis
ottokar	otakar
otto	otto
oulangan	oulanka
ould	ould
oulunkylän	oulunkylä
oulun	oulu
oulun	oulun
outi	outi
outlook	outlook
outta	outta
ovetškin	ovetškin
owen	owen
owens	owens
oxenstierna	oxenstierna
oxfordin	oxfordi
oxford	oxford
öyster	öyster
ozzy	ozzy
pääesikunta	peastaap
pääkkönen	pääkkönen
pääministeri	peaminister
päärautatieasema	pearaudteejaam
paasikivi	paasikivi
paasilinna	paasilinna
paasio	paasio
päätalo	päätalo
paavo	paavo
pablo	pablo
pacific	pacific
pacius	pacius
packers	packers
paco	paco
paddy	paddy
padovan	padova
page	page
paha	paha
pahat	pahat
pähkinäsaaren	pähkinäsaari
pahlavi	pahlavī
paine	paine
paint	paint
paisley	paisley
päivää	päeva
päivä	päev
päivi	päivi
pajalan	pajala
pajala	pajala
pajari	pajari
pajula	pajula
pajunen	pajunen
pajun	paju
paju	paju
pakarinen	pakarinen
pakistanin	pakistani
pakkala	pakkala
pakkanen	pakkanen
pakolaisten	pagulasseisundi
paksu	paks
palace	palace
palacio	palacio
palacios	palacios
palais	palais
palander	palander
palau	belau
palaun	belau
palau	palau
palava	põlev
palazzo	palazzo
pale	pale
palermon	palermo
palermo	palermo
palestiinan	palestiina
palin	palin
pallas	pallas
pallo	jalgpallur
pallokenttä	pallokenttä
palma	palma
palmas	palmas
palme	palme
palmer	palmer
palmu	palmioks
palmyran	palmyra
paloheimo	paloheimo
pál	pál
pamela	pamela
panaman	panama
panathinaikos	panathinaikόs
pandoran	pandora
panin	panin
panis	panis
panizzi	panizzi
panssariarmeija	tankiarmee
panther	panther
panthers	panthers
pantteri	panter
pantterit	pantrid
panzerkampfwagen	pzkpfw
paolo	paolo
papadopoulos	papadópoulos
papen	papen
papers	papers
papua-uusi-guinea	uus-guinea
parade	parade
paradise	paradise
paradis	paradis
paradoksi	paradoks
paraguayn	paraguay
paraguay	paraguay
paras	parim
paratiisissa	paradiisis
pariisin	pariisi
pari	paar
paris	paris
parker	parker
parkinsonin	parkinsoni
parkinson	parkinson
park	park
parks	parks
parlamentaarinen	parlamentaarne
parlamenttitalo	parlamendihoone
parlamenttivaalit	parlamendivalimised
parland	parland
parman	parma
parma	parma
parnell	parnell
pärnun	pärnu
pärnu	pärnu
paroni	parun
pär	pär
parra	parra
parry	parry
parsons	parsons
partido	partido
partners	partners
parts	parts
party	party
parviainen	parviainen
pasanen	pasanen
pascal	pascal
pascual	pascual
pasha	pasha
pasilan	pasila
pasi	pasi
pasolini	pasolini
paso	paso
pasquale	pasquale
pašša	paša
pašša	paşa
passat	passat
passer	passer
pasternak	pasternak
pasteur	pasteur
pastor	pastor
patagonian	patagoonia
paterson	paterson
pathfinder	pathfinder
pato	pato
patrese	patrese
patria	patria
patriarkaatin	patriarhaadi
patriarkka	patriarh
patrice	patrice
patricia	patricia
patrickin	patricki
patrickin	patricku
patrick	patrick
patrik	patrik
patriot	patriot
patriots	patriots
patsas	ausammas
päts	päts
patsy	patsy
patteri	patarei
patterson	patterson
pattinson	pattinson
patti	patti
patton	patton
patty	patty
paulaharju	paulaharju
paula	paula
paulette	paulette
pauliina	pauliina
paulina	paulina
pauline	pauline
paulista	paulista
paulo	paulo
paul	paul
paulsen	paulsen
pavel	pavel
pavljutšenkova	pavljutšenkova
pavlova	pavlova
pavlov	pavlov
paweł	paweł
paxton	paxton
payne	payne
pays	pays
pazin	pazi
peak	peak
peaks	peaks
pearl	pearl
pearson	pearson
peder	peder
pedersen	pedersen
pedersören	pedersöre
peel	peel
peer	peer
peeter	peeter
pehr	pehr
peirce	peirce
pekingin	pekingi
pekingissä	pekingis
pekkala	pekkala
pekka	pekka
pekkarinen	pekkarinen
pelicans	pelicans
pelkonen	pelkonen
pellegrino	pellegrino
pelle	pelle
pelli	pelli
pembroke	pembroke
pena	pena
peña	peña
penguin	penguin
penguins	penguins
pennanen	pennanen
pennetta	pennetta
penn	penn
pennsylvanian	pennsylvania
penny	penny
penrose	penrose
pentium	pentium
penttilä	penttilä
pentti	pentti
penzan	penza
people	people
pepper’s	pepper's
peppers	peppers
percy	percy
pereira	pereira
perelman	perelman
peres	peres
perez	perez
pérez	pérez
perfect	perfect
pergamonin	pergamoni
perhe	perekond
perimyssota	pärilussõda
peri	peri
perkins	perkins
perlman	perlman
perl	perl
permanto	permanto
permin	permi
perm	perm
perón	perón
perrault	perrault
perrin	perrin
perry	perry
perse	perse
pershing	pershing
persian	pärsia
persson	persson
pertti	pertti
perugia	perugia
perun	peruu
perustavan	asutava
pessimistinen	pessimistlik
pestovon	pestovo
pétain	pétain
petäjäveden	petäjävesi
petelius	petelius
pete	pete
péter	péter
petersburg	petersburg
petersen	petersen
peterson	peterson
petite	petite
petra	petra
petrarca	petrarca
petri	petri
petro	petro
petroskoin	petroskoi
petrova	petrova
petrović	petrović
petrovitš	petrovitš
petrov	petrov
petr	petr
petrus	petrus
petšoran	petšora
petteri	petteri
petter	petter
petterson	petterson
pettersson	pettersson
petty	petty
peugeot	peugeot
peyton	peyton
pfeiffer	pfeiffer
phan	phan
phantom	phantom
phelps	phelps
philadelphia	philadelphia
philippa	philippa
philippe	philippe
philip	philip
philipp	philipp
philippus	philippus
phillip	phillip
philosophiae	philosophiae
philosophical	philosophical
phil	phil
phnom	phnom
phoebe	phoebe
phoenix	phoenix
phone	phone
phyllis	phyllis
piaf	piaf
piazza	piazza
piazzolla	piazzolla
picasso	picasso
piccadilly	piccadilly
pico	pico
pictures	pictures
piece	piece
piemonten	piemonte
pierce	pierce
pierluigi	pierluigi
piero	piero
pier	pier
pierre	pierre
pietarhovin	peterhofi
pietarinen	pietarinen
pietarin	peetri
pietarin	peterburi
pietari-paavalin	peeter-pauli
pietari	peeter
pietari	petar
pietilä	pietilä
piet	piet
pietro	pietro
pihkovan	pihkva
pihlajamäki	pihlajamäki
piiritys	piiramine
piispa	piiskop
piitimen	piteå
pike	pike
pilatus	pilatus
pilke	pilke
pill	pill
pilots	pilots
piłsudski	piłsudski
pilvi	pilv
pimeys	pimeduses
pine	pine
pingviini	pingviin
pink	blackpink
pink	pink
pinochet	pinochet
pinot	pinot
pinta-alan	pindala
pinto	pinto
pioneer	pioneer
piotr	piotr
piper	piper
piquet	piquet
pirates	pirates
pires	pires
piri	piri
pirita	pirita
pirjo	pirjo
pirkka-pekka	pirkka-pekka
pirkko	pirkko
pisan	pisa
pistols	pistols
pitkäkarvainen	pikakarvaline
pitkämäki	pitkämäki
pitkärannan	pitkäranta
pitkätossu	pikksukk
pitkien	pikkade
pittin	pittin
pitt	pitt
pittsburghin	pittsburghi
pittsburgh	pittsburgh
pius	pius
pizarro	pizarro
pjotr	pjotr
place	place
placid	placid
planckin	plancki
planck	planck
planeetan	planeedi
planeetta	planeet
planeettojen	planeedi
plan	plaan
plan	plan
plant	plant
plastic	plastic
plata	plata
platonin	platoni
playground	playground
playing	playing
plays	plays
playstation	playstation
plaza	plaza
plesetskin	plessetski
plinius	plinius
plummer	plummer
plus	plus
plymouth	plymouth
plzeňin	plzeňi
pohjala	pohjala
pohjanmeren	põhjamere
pohjanpalo	pohjanpalo
pohjan	põhjasõda
pohjantähden	põhjatähe
pohjois-atlantin	põhja-atlandi
pohjois-carolinan	põhja-carolina
pohjois-egean	põhja-egeuse
pohjois-kaukasian	põhja-kaukaasia
pohjois-korean	põhja-korea
pohjois-korea	põhja-korea
pohjois-kyproksen	põhja-küprose
pohjoismaiden	põhjamaade
pohjoismainen	põhjamaade
pohjois-ossetia-alanian	põhja-osseetia
pohjois-saksan	põhja-saksa
pohjolan	põhjala
pohjonen	pohjonen
pojat	pojad
pojat	pojat
poker	poker
polanyi	polanyi
polar	polar
polatskin	polotski
police	police
poliisi	politsei
poliittisia	poliitiliste
poli	poli
politiikka	poliitika
politiques	poliitikauuringute
polk	polk
pollock	pollock
polly	polly
polo	polo
poltetun	põletatud
polynesian	polüneesia
pommerin	pomorze
pommeri	pommeri
pommitukset	pommitamine
pompeius	pompeius
pompidou	pompidou
ponce	ponce
ponta	ponta
ponte	ponte
pontius	pontius
pont	pont
pontus	pontus
popol	popol
popov	popov
poppanen	poppins
popper	popper
popp	popp
porfyrioksen	porphyriose
porgy	porgy
porin	pori
porkkalan	porkkala
porsche	porsche
portaali	portaal
portable	portable
porter	porter
porthan	porthan
portia	portia
portland	portland
porto	porto
portugalin	portugali
portugal	portugal
porvoon	porvoo
positiivinen	positiivne
posse	posse
posti	posti
post	post
potro	potro
potsdamer	potsdami
potsdamin	potsdami
potter	potter
poul	poul
pound	pound
pour	pour
powell	powell
power	power
powers	powers
pöytätennis	lauatennis
poznańin	poseni
poznańin	poznańi
prääsän	prääsä
pradesh	pradesh
prahan	praha
pratt	pratt
pravda	pravda
prayer	prayer
pray	pray
preerialla	preerias
prefektuuri	prefektuur
prescott	prescott
presence	presence
presidentinvaali	presidendivalimised
presidentinvaalit	presidendivalimised
presidentti	president
presley	presley
press	press
preston	preston
pretty	pretty
preussin	preisi
preussin	preisimaa
price	price
priestley	priestley
priest	priest
priha	priha
primaarinen	primaarne
primal	primal
prima	prima
primeira	primeira
primera	primera
primetime	primetime
primorjen	primorje
primorjen	primorski
prince	prince
princetonin	princetoni
príncipen	príncipe
príncipe	príncipe
principia	principia
prinsessa	printsess
prinssin	printsi
prinssi	prints
priscilla	priscilla
pritchard	pritchard
probe	probe
prodigy	prodigy
productions	productions
professori	professor
prohorov	prohhorov
project	project
project	projekt
projektio	projektsioon
projekti	project
projekti	projekt
prokofjev	prokofjev
proletariaatin	proletariaadi
pronssikauden	pronksiaja
prosessi	protsess
prospekt	prospekt
prosper	prosper
prost	prost
protocol	protocol
proud	proud
proust	proust
provence-alpes-côte	provence-alpes-côte
providencen	providence'i
provinssit	provintsid
psychological	psühholoogide
psykologia	psühholoogia
psykologinen	psühholoogiline
psykoterapia	lühiteraapia
ptolemaios	ptolemaios
ptolemaiosten	ptolemaioste
publican	publica
publius	publius
puccini	puccini
puerto	puerto
puget	puget
puhakka	puhakka
puhdistus	puhastus
puhtaan	puhta
puijon	puijo
pukinmäen	pukinmäki
pulkkinen	pulkkinen
pullin	pulli
pulli	pulli
pullo	pudel
pulssi	impulss
pultavan	poltaava
pultavan	poltava
punainen	punane
punaisen	punase
punaiset	punased
punk	punk
puolaan	poolale
puolan	poola
puolassa	poolas
puolikuu	poolkuu
puolimaratonin	poolmaratoni
puolustusministeri	kaitseminister
puolustusministeriö	kaitseministeerium
puotilan	puotila
puppets	puppets
puppy	puppy
purcell	purcell
puri	puri
purje	puri
purje	purje
purple	purple
puskás	puskás
pussy	pussy
putin	putin
putnam	putnam
puudožin	puudosi
pylkkänen	pylkkänen
pyramidi	püramiid
pyramidit	püramiidid
pyramid	pyramid
pyreneiden	pürenee
pyrintö	pyrintö
pythagoraan	pythagorase
pyykkö	pyykkö
qatarin	katari
qatar	qatar
qian	qian
quảng	quảng
quasimodo	quasimodo
québecin	québeci
queen	queen
queens	queens
quest	quest
qui-gon	qui-gon
quijote	quijote
quincy	quincy
quine	quine
quinn	quinn
quintana	quintana
quintus	curtius
raadin	raadi
raamatun	raamatute
raappana	raappana
raaseporin	raasepori
raatteen	raate
rabin	rabin
rachel	rachel
racing	racing
rada	ülemraada
radcliffe	radcliffe
radek	radek
radeon	radeon
radikaali	radikale
radio	raadio
radio	radio
radisson	radisson
radwańska	radwańska
rafael	rafael
ragnar	ragnar
rahmaninov	rahmaninov
rahman	rahman
rahman	rahmān
raider	raider
raija	raija
räikkönen	räikkönen
raila	raila
raili	raili
railways	railways
raimo	raimo
raimund	raimund
rainbow	rainbow
rainer	rainer
rainier	rainier
rain	rain
raisa	raissa
raivo	raivo
raja	raja
rajiv	rajiv
raju	raju
rakel	rakel
rakkaus	armastus
ralf	ralf
rallin	autoralli
ralli	ralli
ralph	ralph
rama	rama
rameau	rameau
ramin	ramin
rami	rami
ramírez	ramírez
ramón	ramón
ramos	ramos
ramsay	ramsay
ramses	ramses
ramsey	ramsey
rana	rana
rancho	rancho
randall	randall
randolph	randolph
rand	rand
randy	randy
rangaistus	karistus
rangers	rangers
ranieri	ranieri
ranskan	prantsusmaa
rantala	rantala
rantanen	rantanen
raoul	raoul
raphael	raphael
rapids	rapids
raptor	raptor
raptors	raptors
räsänen	räsänen
rashid	rashīd
raskas	raske
rasmus	rasmus
rasmussen	rasmussen
raspberry	raspberry
rasputin	rasputin
ra’s	ra's
rastilan	rastila
rata	raudtee
ratas	ratas
ratia	ratia
rationalismi	ratsionalism
ratsumies	ratsanikust
rauhanturvaajien	rahuvalvajate
rauha	rahu
raul	raul
raúl	raúl
raumanmeren	rauma
rauno	rauno
rautakausi	rauaaeg
rautanen	rautanen
rautatieasema	raudteejaam
rautatieasema	raudteepeatus
rautatie	raudtee
rautatiet	raudteed
rautavaara	rautavaara
rautiainen	rautiainen
ravel	ravel
ravennan	ravenna
raven	raven
ravi	ravi
raymond	raymond
rayo	rayo
reaaliaikainen	reaalaja
reading	reading
reagan	reagan
reaktion	reaktsiooni
reaktio	reaktsioon
realismi	realism
reality	reality
real	real
rebecca	rebecca
rebekka	rebekka
rebel	rebel
recep	recep
reckless	reckless
reconnaissance	reconnaissance
recreativo	recreativo
redemption	redemption
redford	redford
redknapp	redknapp
redmond	redmond
reed	reed
reese	reese
rees	rees
reeve	reeve
reeves	reeves
reformipuolue	reformierakond
reggie	reggie
reggio	reggio
reginald	reginald
regina	regina
regional	regional
register	register
registry	registry
rehbinder	rehbinder
rehn	rehn
reich	reich
reid	reid
reijonen	reijonen
reijo	reijo
reilly	reilly
reiman	reiman
reima	reima
reina	reina
reinhard	reinhard
reinhardt	reinhardt
reinhart	reinhart
reinhold	reinhold
reinin	reini
reino	reino
rein	rein
reis	reis
rekola	rekola
relander	relander
religion	religion
remains	remains
remedy	remedy
remes	remes
remote	remote
remu	remu
remus	remus
renault	renault
renée	renée
rené	rené
renessanssin	renessanssmuusika
renessanssi	renessanss
rengas	ring
renner	renner
renny	renny
renoir	renoir
repin	repin
repo	repo
report	report
republic	republic
rescue	rescue
reseptori	retseptor
reseptori	retseptorid
reserve	föderaalreservi
resistance	resistance
resta	resta
rest	rest
retro	retro
return	return
reus	reus
revelations	revelations
revisited	revisited
revival	revival
reyes	reyes
reynoldsin	reynoldsi
reynolds	reynolds
reznor	reznor
rhapsody	rhapsody
rhoads	rhoads
rhode	rhode
rhônen	rhône'i
rhymes	rhymes
rhys	rhys
rhythm	rütm
ribbentrop	ribbentrop
ribeiro	ribeiro
rican	rica
ricardo	ricardo
riccardo	riccardo
ricciardo	ricciardo
ricci	ricci
rice	rice
richard	richard
richardson	richardson
richards	richards
richelieu	richelieu
rich	rich
richter	richter
rickman	rickman
rick	rick
ricky	ricky
ricon	rico
rico	rico
ride	ride
rider	rider
ridley	ridley
riemannin	riemanni
riemukaari	triumfikaar
rights	rights
riian	riia
riikka	riikka
riitta	riitta
riki	riki
rimski-korsakov	rimski-korsakov
ringo	ringo
ring	ring
rinnasta	rinnast
rioja	rioja
río	río
riot	riot
ripley	ripley
rise	rise
ristiinnaulitseminen	ristilöömine
ristin	risti
ritarikunnan	rüütelkonna
rita	rita
ritchie	ritchie
ritter	ritter
ritva	ritva
rivera	rivera
river	river
riverside	riverside
rivers	rivers
riviera	riviera
rjazanin	rjazani
road	road
roald	roald
roar	roar
robben	robben
robb	robb
roberta	roberta
roberto	roberto
robert	robert
robertson	robertson
roberts	roberts
robespierre	robespierre
robin	robin
robinsonin	robinsoni
robinson	robinson
robles	robles
robotit	robot
robot	robot
rocca	rocca
rocco	rocco
rocha	rocha
roche	roche
rockets	rockets
rock-musiikin	rokkmuusikastiilide
rock	rock
rocks	rocks
rockstar	rockstar
roda	roda
roddick	roddick
rodgers	rodgers
rodman	rodman
rodney	rodney
rodoksen	rhodose
rodrigo	rodrigo
rodrigues	rodrigues
rodriguez	rodriguez
rodríguez	rodríguez
roger	roger
rogers	rogers
röhm	röhm
roininen	roininen
rojas	rojas
rojo	rojo
roki	roki
roland	roland
rolf	rolf
rolland	rolland
rolling	rolling
rollins	rollins
rollo	rollo
roll	rock'n'roll
roll	roll
romaaninen	romaani
romaani	romaan
romain	romain
romana	romana
romance	romance
romanian	rumeenia
romanien	romade
roman	roman
roma	roma
rome	rome
rommel	rommel
romney	romney
romulus	romulus
ronaldo	ronaldo
rondo	rondo
ronny	ronny
röntgen	röntgen
rooli	roll
roomalaiset	rooma
roomalaisille	roomlastele
rooman	rooma
roomassa	roomas
rooney	rooney
roosevelt	roosevelt
rooster	rooster
root	root
roque	roque
rosalind	rosalind
rosa	rosa
rosberg	rosberg
roscoe	roscoe
rosemary	rosemary
rosenberg	rosenberg
rosenborgin	rosenborgi
rosenqvist	rosenqvist
rosen	rosen
rose	rose
roses	roses
rosie	rosie
roskilden	roskilde
rossini	rossini
rossi	rossi
rosso	rosso
ross	ross
rostockin	rostocki
rostovin	rostovi
rostov	rostov
roswellin	roswelli
roth	roth
rouge	rouge
round	round
rousseau	rousseau
route	route
routledge	routledge
rovaniemen	rovaniemen
rovaniemen	rovaniemi
rovanperä	rovanperä
rovers	rovers
rowan	rowan
rowland	rowland
rowling	rowling
royal	royal
royce	royce
rubber	rubber
ruben	ruben
rubén	rubén
rubens	rubens
rubikin	rubiku
rubinstein	rubinstein
rubio	rubio
ruby	ruby
rudd	rudd
rüdiger	rüdiger
rudi	rudi
rudolf	rudolf
rudolph	rudolph
rudyard	rudyard
rufus	rufus
rugby	ragbi
ruhrin	ruhri
ruiz	ruiz
rule	rule
runeberg	runeberg
rune	rune
rung	rung
runner	runner
running	running
ruoholahden	ruoholahti
ruotsinkielinen	rootsikeelne
ruotsin	rootsi
ruotsissa	rootsis
ruotsi	uus-rootsi
rupert	rupert
rupla	rubla
rushdie	rushdie
rush	rush
ruska	ruska
ruslan	ruslan
russan	russa
russell	russell
russel	russel
russ	russ
rust	rust
rutgersin	rutgersi
rutherford	rutherford
ruth	ruth
ruud	ruud
ruutu	ruutu
ruuvi	kruvi
rydberg	rydberg
ryder	ryder
ryhänen	ryhänen
ryhmä	rühm
ryömä	ryömä
ryszard	ryszard
ryti	ryti
saab	saab
saad	saad
saad	sa‘d
saaga	saaga
saakašvili	saakašvili
saamen	saami
saara	saara
saarela	saarela
saarenmaan	saaremaa
saarenmaa	saaremaa
saaren	saare
saaret	saared
saaret	saarestik
saariaho	saariaho
saarikoski	saarikoski
saarinen	saarinen
saari	saar
saaristo	saared
saaristo	saarestik
saaristo	saaristo
saaritsa	saaritsa
saarni	saar
saar	saar
saastamoinen	saastamoinen
saastuminen	õhusaastus
saatana	saatan
saat	saat
saban	seeba
saba	saba
sabbath	sabbath
sabina	sabina
sabine	sabine
sabre	sabre
sabres	sabres
sachs	sachs
sachs	sachsi
sacramento	sacramento
sada	sada
saddam	şaddām
sade	sade
safari	safari
šafářová	šafářová
safin	safin
sagan	sagan
saga	saga
sage	sage
sahalinin	sahhalini
sahan	sahha
saharan	sahara
saha	saag
saha	saha
said	said
saif	sayf
sailor	sailor
saimaan	saimaa
saimi	saimi
saint-germain	saint-germain
saint-pierre	saint-pierre
saint-saëns	saint-saëns
saint	saint
saints	saints
sainz	sainz
sairaala	haigla
sairaiden	salvimise
sairaus	haigus
saisio	saisio
saitaman	saitama
sakai	sakai
sakari	sakari
sakata	sakata
sakon	sakon
saksalainen	sakslane
saksalais-roomalainen	saksa-rooma
saksalaisten	volgasakslaste
saksalle	saksamaale
saksankielinen	saksakeelne
saksan	saksa
saksan	saksamaa
saksin	saksimaa
saksi	saksimaa
sakura	sakura
saku	saku
salaam	salaam
salad	salad
salaisuus	saladus
salatut	varjatud
salazar	salazar
salemin	salemi
sales	sales
salieri	salieri
salin	salin
sali	sali
salisburyn	salisbury
salisbury	salisbury
salla	salla
salle	salle
sallinen	sallinen
sally	sally
salman	salman
salman	salmān
salmen	salme
salme	salme
salminen	salminen
salokannel	salokannel
salolainen	salolainen
salomäki	salomäki
salome	salomé
salomon	saalomoni
salomonsaarten	saalomoni
salomon	salomon
salo	salo
salpausselän	salpausselkä
salt	salt
salute	salute
salvadorin	salvadori
salvador	salvador
samantha	samantha
samaran	samara
samara	samara
sambian	sambia
šamilin	šamili
šamil	šamil
samir	samir
sami	sami
sámi	sámi
samoan	samoa
samoa	samoa
sampo	sampo
samppa	samppa
samsung	samsung
samuel	samuel
samuelsson	samuelsson
samuli	samuli
samu	samu
sanaa	sõna
sanat	sõnad
sánchez	sánchez
sandberg	sandberg
sandels	sandels
sander	sander
sanders	sanders
sandler	sandler
sandman	sandman
sándor	sándor
sandra	sandra
sandro	sandro
sand	sand
sandy	sandy
sang	sang
sani	sani
sankarit	sangarid
sankt	sankt
sanna	sanna
sanni	sanni
sanoi	sanoi
sanomat	sanomat
sano	sano
sansibarin	inglise-sansibari
santana	santana
santander	santander
santa	santa
santiago	santiago
santi	santi
santo	santo
santos	santos
são	são
sapphire	sapphire
sarah	sarah
sarajevon	sarajevo
sara	sara
saraste	saraste
sarasvuo	sarasvuo
saratovin	saraatovi
saratovin	saratovi
sardinian	sardiinia
sargent	sargent
sargon	sargon
sariola	sariola
sari	sari
sarkola	sarkola
sarkozy	sarkozy
sartre	sartre
sarvi	sarv
sasha	sasha
sasi	sasi
saskatchewanin	saskatchewani
sasuke	sasuke
sasu	sasu
satama	sadam
satamat	sadamad
sata	sada
sata	sata
satie	satie
satoru	satoru
satoshi	satoshi
saturday	saturday
saturn	saturn
saturnuksen	saturni
saturnus	saturn
satu	satu
saudi-arabia	araabia
saudi-arabian	saudi
sauli	sauli
saul	saul
sault	sault
sauna	saun
saussure	saussure
sauvignon	sauvignon
savage	savage
save	save
savoijin	savoia
savolainen	savolainen
savola	savola
savon	savon
saxo	saxo
scala	scala
scandia	scandia
scandinavian	scandinavian
scania	scania
scared	scared
scarlett	scarlett
scars	scars
scene	scene
schäfer	schäfer
schalke	schalke
scharnhorst	scharnhorst
schatz	schatz
schauman	schauman
schell	schell
scherzinger	scherzinger
schiavone	schiavone
schiff	schiff
schiller	schiller
schleswigin	schleswigi
schlierenzauer	schlierenzauer
schmalkaldenin	schmalkaldeni
schmidt	schmidt
schneider	schneider
scholar	scholar
scholl	scholl
schönberg	schönberg
school	school
schopenhauer	schopenhauer
schröder	schröder
schrödingerin	schrödingeri
schubert	schubert
schuldiner	schuldiner
schultén	schultén
schulz	schulz
schumacher	schumacher
schumann	schumann
schuster	schuster
schütz	schütz
schwartz	schwartz
schwarzenberg	schwarzenberg
schwarzenegger	schwarzenegger
schwarzkopf	schwarzkopf
schwarz	schwarz
schwerin	schwerin
science	science
sciences	sciences
scientific	scientific
scientist	scientist
scipio	scipio
scorsese	scorsese
scotia	scotia
scotland	scotland
scottie	scottie
scottin	scotti
scottish	scottish
scott	scott
scotty	scotty
scotus	scotus
scuderia	scuderia
sdkfz	sdkfz
seagal	seagal
seagulls	seagulls
seamus	seamus
sean	sean
seán	seán
seas	seas
seat	seat
seattle	seattle
seattlessa	seattle'is
sebastian	sebastian
sebastián	sebastián
sébastien	sébastien
seconds	seconds
secret	secret
secure	secure
sedanin	sedani
sedgwick	sedgwick
seeger	seeger
segal	segal
segerstam	segerstam
segežan	segeža
ségoun	ségou
seikkailut	seiklused
seinään	seina
seinäjoen	seinäjoki
seinä	sein
sein	sein
seitsemän	seitse
seitsemäs	seitsmes
seksuaalinen	seksuaalne
seksuaalisuus	seksuaalsuhe
sektori	sektor
sekunnissa	sekundiga
sekunnissa	sekundis
selänne	selänne
selän	selja
selassie	selassie
selena	selena
self	self
selim	selim
selina	selina
sellers	sellers
sello	sello
sell	selli
selma	selma
semanttinen	semantiline
seminaari	seminar
semjonov	semjonov
semjon	semen
semjon	semjon
semper	semper
senaatti	senat
senecan	seneca
senegalin	senegali
senna	senna
sepän	sepa
seppälä	seppälä
seppänen	seppänen
seppo	seppo
sepp	sepp
septimius	septimius
sera	sera
serbia	serbia
serenade	serenade
sergei	sergei
serge	serge
sergio	sergio
sérgio	sérgio
sergius	sergius
serie	serie
serotoniinin	serotoniini
serra	serra
server	server
service	service
sese	sese
sessions	sessions
seth	seth
seti	seti
seton	setu
seuloskoin	vsevoložski
seurat	seurat
sevenfold	sevenfold
seventh	seventh
severin	severin
severnaja	severnaja
severus	severus
sevillan	sevilla
sevilla	sevilla
ševtšenko	ševtšenko
sextus	sextus
seychellien	seišelli
seychellien	seišellide
seychellien	seišellikreooli
seymour	seymour
sfinksi	sfinks
sforza	sforza
shackleton	shackleton
shadow	shadow
shadows	shadows
shahar	shaẖar
shakespeare	shakespeare
shakur	shakur
shandong	shandong
shane	shane
shanghain	shanghai
shanghai	shanghai
shankar	shankar
shanks	shanks
shape	shape
sharif	shariif
sharm	sharm
sharon	sharon
sharp	sharp
shawn	shawn
shaw	shaw
shay	shay
shearer	shearer
shea	shea
sheen	sheen
sheffieldin	sheffieldi
sheffield	sheffield
sheikh	shiikh
sheldon	sheldon
shelleyn	shelley
shelley	shelley
shell	shell
shen	shen
shenzhou	shenzhou
shepard	shepard
sheppard	sheppard
sheridan	sheridan
sheriff	sheriff
sherlock	sherlock
sherman	sherman
sherwood	sherwood
shield	shield
shields	shields
shikai	shikai
shimon	shim'on
shindō	shindō
shinji	shinji
shinoda	shinoda
shin	shin
shirley	shirley
shiva	shiva
shockley	shockley
shoes	shoes
shop	shop
shore	shore
shorter	shorter
show	show
shuffle	shuffle
shuttle	shuttle
siad	siyaad
siat	siga
sibelius	sibelius
sibley	sibley
sideshow	sideshow
side	side'i
sides	sides
sidi	sidi
sidney	sidney
sidos	side
siècle	siècle
siegel	siegel
siegfried	siegfried
siekkinen	siekkinen
siemens	siemens
sienan	siena
siena	siena
sierra	sierra
sievers	sievers
sievinen	sievinen
sigismund	sigismund
signaali	signal
signal	signal
sigrid	sigrid
sigtunan	sigtuna
sigurd	sigurd
sigur	sigur
sihanouk	sihanouk
siikala	siikala
siilasvuo	siilasvuo
siili	siil
siionin	siioni
siiri	siiri
siitonen	siitonen
sika	siga
sikasson	sikasso
sikorsky	sikorsky
sikstuksen	sixtuse
silk	silk
sillanpää	sillanpää
sillan	silla
sille	sille
silmä	silm
silta	sild
silvan	silvan
silva	silva
silverman	silverman
silver	silver
silvia	silvia
silvio	silvio
sima	sima
simberg	simberg
simenon	simenon
simeoni	simeoni
simmel	simmel
simone	simone
simon	simon
simón	simón
simons	simons
simo	simo
simple	simple
simpson	simpson
šimskin	šimski
simson	simson
sinatran	sinatra
sinatra	sinatra
sinclair	sinclair
sinervo	sinervo
sinfonia	sümfoonia
sinfoninen	sümfooniline
singaporen	singapuri
singer	singer
singh	singh
single	single
sing	sing
sinikka	sinikka
sininen	sinine
sinisalo	sinisalo
sinnemäki	sinnemäki
sinne	sinna
sinn	sinn
sint	sint
sinuhe	sinuhe
sipilä	sipilä
sirén	sirén
siri	siri
sirkka-liisa	sirkka-liisa
sirkka	sirkka
sirkus	tsirkus
sirppi	sirp
sisäministeriö	siseministeerium
sisiliain	sitsiilia
sisilialainen	sitsiilia
sisilian	sitsiilia
sister	sister
sisu	sisu
sitominen	sidumine
siviili-ilmailun	tsiviillennunduse
sixtus	sixtus
sjögrenin	sjögreni
sjöström	sjöström
skandinaavinen	skandinaavia
skandinavian	skandinaavia
skandinavia	skandinaavia
skånen	skåne
skeleton	skeleton
skellefteån	skellefteå
skinner	skinner
škoda	škoda
skynyrd	skynyrd
slade	slade
sleepers	sleepers
sleepy	sleepy
sleesian	sileesia
slick	slick
slim	slim
slobodan	slobodan
slocum	slocum
slovakian	slovakkia
slovakia	slovakkia
slovenian	sloveenia
slovenia	sloveenia
small	small
smart	smart
smeds	smeds
smirnov	smirnov
smith	smith
smoke	smoke
smolenskin	smolenski
smooth	smooth
snellman	snellman
snookerin	snuukeri
snoop	snoop
snorri	snorri
snowden	snowden
snow	snow
snyder	snyder
soccer	soccer
sociedad	sociedad
society	society
socket	socket
socket	sokkel
söderberg	söderberg
söderblom	söderblom
södergran	södergran
söderhjelm	söderhjelm
söderling	söderling
södermanlandin	södermanlandi
södertäljen	södertälje
södra	södra
sofian	sofia
sofia	sofia
sofia	sofja
sofia	sophia
sofie	sofie
sofi	sofi
soft	soft
software	software
sognin	sogn
soikkanen	soikkanen
soini	soini
sojuz	sojuz
sokolov	sokolov
sokrateen	sokratese
solaris	solaris
solar	solar
solberg	solberg
soler	soler
solmu	sõlm
solomon	solomon
solo	solo
solovetskin	solovetsi
solženitsyn	solženitsõn
somalian	somaalia
somalin	somaali
someone	someone
somerset	somerset
somerville	somerville
something	something
somewhere	somewhere
sommen	somme'i
sonata	sonata
song	song
songs	songs
sonia	sonia
sonic	sonic
sonja	sonja
sonny	sonny
sonoran	sonora
sons	sons
sony	sony
sopeutuminen	kohanemine
sophia	sophia
sophie	sophie
sørensen	sørensen
søren	søren
sormuksen	sõrmuse
sormus	sõrmus
sormusta	sõrmused
sormusten	sõrmuste
sörnäisten	sörnäineni
sorsa	sorsa
sortavalan	sortavala
sosa	sosa
sosiaalidemokraattinen	sotsiaaldemokraatlik
sosiaalinen	sotsiaalne
sosiaalisten	sotsiaalse
sosialismi	sotsialism
sosialistinen	sotsialistlik
sosialistit	sotsialistid
sosnovyi	sosnovõi
šostakovitš	šostakovitš
sotamies	reamees
sotaretkestä	sõjaretkest
soul	soul
sounds	sounds
southampton	southampton
southern	southern
south	south
soutjärven	šoutjärvi
sovereign	sovereign
space	space
spain	spain
sparks	sparks
spartak	spartak
spartan	spartan
sparta	sparta
speak	speak
spears	spears
special	special
species	species
spectre	spectre
spectrum	spectrum
spede	spede
speech	speech
speed	speed
speer	speer
spee	spee
spelling	spelling
spell	spell
spencer	spencer
spengler	spengler
spice	spice
spiders	spiders
spielberg	spielberg
spike	spike
spinoza	spinoza
spiraali	spiraal
spitfire	spitfire
spitz	spitz
spontaani	spontaanne
sporting	sporting
sport	sport
sports	sports
sprache	sprache
sprengtporten	sprengtporten
springer	springer
springs	springs
springsteen	springsteen
spurs	spurs
sputnik	sputnik
spvgg	spvgg
square	square
squaw	squaw
squire	squire
ss-divisioona	ss-diviis
ss-divisioona	ss-soomusdiviis
stabat	stabat
stade	stade
stadion	staadion
stadio	stadio
stadium	stadium
stadler	stadler
stafford	stafford
ståhlberg	ståhlberg
stalingradin	stalingradi
stalinin	stalini
stalin	stalin
stamford	stamford
standardi	sisestandard
standardi	standard
stand	stand
stanfordin	stanfordi
stanford	stanfordi
stanin	stani
stanislas	stanislas
stanislav	stanisłaŭ
stanislav	stanislav
stanisław	stanisław
stan	stan
stanton	stanton
staples	staples
staraja	staraja
stara	stara
stardust	stardust
starkin	starki
stark	stark
starkweather	starkweather
starr	starr
starship	starship
stars	stars
star	star
staten	staten
state	state
static	static
stauffenberg	stauffenberg
stavangerin	stavangeri
stavanger	stavanger
stavropolin	stavropoli
steal	steal
steam	steam
steelers	steelers
steele	steele
steel	steel
stefania	stefania
stefano	stefano
stéfano	stéfano
stefan	stefan
steffen	steffen
steinbeck	steinbeck
steinberg	steinberg
steiner	steiner
steinitz	steinitz
stella	stella
stenbäck	stenbäck
stenberg	stenberg
stenbock	stenbock
sten	sten
stepanov	stepanov
stepan	stepan
stéphane	stéphane
stephan	stephan
stephenie	stephenie
stephenson	stephenson
stephen	stephen
sterling	sterling
sternberg	sternberg
stern	stern
stevenson	stevenson
stevens	stevens
steven	steven
steve	steve
stevie	stevie
sticky	sticky
stiglitz	stiglitz
stig	stig
stina	stina
stitch	stitch
stockholm	stockholm
stockmannin	stockmanni
stoker	stoker
stokes	stokes
stoke	stoke
stolbovan	stolbovo
stoner	stoner
stones	stones
stone	stone
stop	stop
store	store
storm	storm
stosur	stosur
stout	stout
stowe	stowe
straight	straight
straits	straits
strangers	strangers
strängnäsin	strängnäsi
strasbourgin	strasbourgi
strasbourg	strasbourg
strategia	strateegia
strategic	strateegilise
strauss	strauss
strauss	strauß
stravinsky	stravinski
strawberry	strawberry
stray	stray
stream	stream
streep	streep
streetin	streeti
street	street
streisand	streisand
stressi	stress
strickland	hunty-strickland
strindberg	strindberg
strings	strings
stripes	stripes
struve	struve
stuart	stuart
stubbin	stubbi
stubb	stubb
studies	studies
studios	studios
studio	studio
study	study
stump	stump
sture	sture
sturm	sturm
sturm	torm
stuttgartin	stuttgardi
stuttgart	stuttgart
styles	styles
style	style
suárez	suárez
subaru	subaru
subjektiivinen	subjektiivne
subtrooppinen	lähistroopiline
subway	subway
sudanin	sudaani
sudan	sudan
suede	suede
suezin	suessi
suffolkin	suffolki
sugar	sugar
sugiyama	sugiyama
suhoi	suhhoi
suhonen	suhonen
suhteellinen	eelise
suhteellinen	suhtelise
suhteellisuusteoria	üldrelatiivsusteooria
suhteiden	suhete
suite	suite
suit	suit
sukselainen	sukselainen
sukupolvi	sugupõlv
sula	sula
suleiman	suleiman
sulkapallo	sulgpall
sullivan	sullivan
sultan	sultan
sultan	sulțān
sulttaanikunta	sultanaat
summa	summa
summer	summer
sumussa	udus
sundancen	sundance'i
sunderland	sunderland
sundin	sundin
sunny	sunny
sunset	sunset
suns	suns
suojärven	suojärvi
suomalaiset	soomlased
suomalais-ugrilainen	soome-ugri
suomalais-ugrilaiset	soome-ugri
suomalais-ugrilaisten	soome-ugri
suomenkielinen	soomekeelne
suomenlahti	laht
suomen	soome
suominen	suominen
suomi	suomi
superb	superb
supercopa	supercopa
supérieure	supérieure
supermarine	supermarine
superstar	superstaar
super	super
surinamen	suriname
suriname	suriname
surma	surm
surtees	surtees
surveyor	surveyor
susannah	susannah
susanne	susanne
susan	susan
sussex	ida-sussex
sussexin	sussexi
sussex	lääne-sussex
sutela	sutela
suter	suter
sutherland	sutherland
sutil	sutil
suuret	suur
suuret	suured
suurherttua	suurhertsog
suurimmista	suuruse
suuriruhtinas	suurvürst
suuri	suur
suur-lontoon	suur-londoni
suurmogulien	suurmogulite
suu-	suu-
suvorov	suvorov
suzanne	suzanne
suzuki	suzuki
svante	svante
svean	svea
svedberg	svedberg
sveitsin	šveitsi
sveitsi	šveits
svendsen	svendsen
svenska	svenska
svensson	svensson
sven	sven
sverdlovskin	sverdlovski
sveriges	sveriges
sverre	sverre
svetlana	svetlana
svinhufvud	svinhufvud
svjatoslav	svjatoslav
svoboda	svoboda
swahilin	suahiili
swansea	swansea
swan	swan
swazimaan	svaasimaa
sweat	sweat
sweet	sweet
swift	swift
swindon	swindon
swiss	swiss
switch	switch
sydneyn	sydney
sydney	sydney
sydow	sydow
sykes	sykes
syklinen	tsükliline
sylvester	silvester
sylvia	sylvia
sylvi	sylvi
symbolin	sümbolite
symbolit	sümboolika
symmetrinen	sümmeetriline
sympaattinen	sümpaatiline
synagoga	sünagoog
synodi	sinod
synteesi	süntees
synteettinen	sünteetiline
syracusen	syracuse'i
syrjä	syrjä
systems	systems
system	system
sytokromi	tsütokroom
syyrian	süüria
szabó	szabó
taalainmaan	dalarna
taavi	taavi
tabermann	tabermann
table	table
tabula	tabula
tadeusz	tadeusz
taekwondo	taekwondo
taft	taft
tage	tage
tähden	tähe
tahdon	tahte
tahitin	tahiti
tähtien	tähtien
tähtienvälinen	tähtedevaheline
tähti	täht
tahto	tahe
taideakatemia	kunstiakadeemia
taidehalli	kunstihall
taidemuseo	kunstimuuseum
taimyrin	taimõri
taipale	taipale
taipei	taipei
taitoluistelu	iluuisutamine
taitoluistelun	iluuisutamise
taivaan	taivaan
taivas	taevas
taiwanin	taiwani
taka-baikalian	taga-baikali
takahashi	takahashi
takaisin	tagasi
takalo	takalo
takana	taga
takao	takao
takashi	takashi
takeda	takeda
takeshi	takeshi
take	take
taksonomia	taksonoomia
taktiikka	taktika
takuma	takuma
talbot	talbot
talent	talent
talib	ţālib
tali	tali
talk	talk
tallgren	tallgren
tallinnan	tallinna
tallinna	tallinna
tallinn	tallinn
talon	talon
talvela	talvela
talviolympialaiset	taliolümpiamängud
talviolympialaisissa	taliolümpiamängudel
talviolympialaisten	taliolümpiamängude
tamara	tamara
tambovin	tambovi
tamili	tamili
tamil	tamil
tammela	tammela
tammelin	tammelin
tammet	tamm
tammi	tamm
tammi	tammi
tampereen	tampere
tampereen	tampereen
tampere	tampere
tanaka	tanaka
tangerine	tangerine
tanja	tanja
tankian	tankian
tanner	tanner
tansanian	tansaania
tanskan	taani
tanskassa	taanis
tanssii	tanssii
tanssi	kõhutants
tanttu	tanttu
tapa	tapa
tape	tape
tapio	tapio
tarantino	tarantino
taranton	taranto
taras	tarass
tarasti	tarasti
tara	tara
tarjanne	tarjanne
tarja	tarja
tarton	tartu
tarzan	tarzan
tasainen	ühtlane
tasangot	tasandik
tasanko	tasandik
tasapaino	tasakaal
taškentin	taškendi
taškentin	toshkendi
tataarin	tatari
tatarstanin	tatarstani
tata	tata
tate	tate
tatjana	tatjana
tatsuya	tatsuya
tattoo	tattoo
tatum	tatum
tatu	tatu
taube	taube
tauno	tauno
tavares	tavares
taxell	taxell
taylorin	taylori
taylor	taylor
täyssinän	täyssinä
tbilisin	thbilisi
team	team
tears	tears
teatern	teatern
teatteritaiteen	teatrikunsti
teatteri	teater
technique	technique
technology	tehnoloogiainstituut
tecumseh	tecumseh
teddy	teddy
teemu	teemu
teet	teet
tehdas	tehas
teheranin	teherani
teiden	teide
teinonen	teinonen
tekniikan	tekniikan
tekniikka	tehnika
teknologia	tehnoloogia
teknologinen	tehnoloogiline
telegraph	telegraph
telekom	telekom
telemann	telemann
telescope	telescope
television	television
televisioon	televisioon
tell	tell
temple	temple
temppeliaukion	temppeliaukio
temppeli	tempel
temptation	temptation
tenerife	tenerife
tennant	tennant
tennessee	tennessee
tennis	tennis
tennisturnaus	tennises
teoderik	theoderich
teodor	teodor
teoreettinen	teoreetiline
teoria	teooria
teot	teod
tepe	tepe
terapia	ravi
teräs	teras
tera	tera
tercera	tercera
terence	terence
teresa	teresa
teresia	theresia
tere	tere
teri	teri
terminal	terminal
tero	tero
terra	terra
terrence	terrence
terre	terre
terry	terry
tervajoen	tervajoki
tervehdys	tervitus
tervomaa	tervomaa
tesla	tesla
tessa	tessa
testaaminen	testimine
testamentti	testament
testi	test
teutoburgin	teutoburgi
teuvo	teuvo
texas	texas
text	text
thaimaan	tai
thai	thai
thaksin	thaksin
thaleen	thalese
thatcher	thatcher
theater	theater
theatre	theatre
thebaa	teeba
thee	thee
theft	theft
théodore	théodore
theodoros	theodoros
theodor	theodor
theory	theory
theo	theo
theresa	theresa
therese	therese
theron	theron
thierry	thierry
things	things
thing	thing
thomas	thomas
thompson	thompson
thomsonin	joule'i-thomsoni
thom	thom
thorin	thorin
thorndike	thorndike
thorne	thorne
thornton	thornton
thorpe	thorpe
thors	thors
thousand	thousand
thrash	thrash
three	three
thrones	thrones
thule	thule
thunderbird	thunderbird
thunderbolt	thunderbolt
thunder	thunder
thurman	thurman
thurston	thurston
thutmosis	thutmosis
tiago	tiago
tiainen	tiainen
tiberius	tiberius
tibor	tibor
tide	tide
tiedekeskus	teaduskeskus
tierney	tierney
tieto-	info-
tigerstedt	tigerstedt
tiheys	tihedus
tihonov	tihhonov
tihvinän	tihvini
tiia	tiia
tiibetiläisten	tiibeti
tiibetin	tiibeti
tiibetissä	tiibetis
tiikerit	tiigrid
tiilikainen	tiilikainen
tiina	tiina
tiitinen	tiitinen
tikkanen	tikkanen
tikkurilan	tikkurila
tilastollisten	statistiliste
till	till
tilly	tilly
timaios	timaios
timberlake	timberlake
time	time
timothy	timothy
timo	timo
timur	timur
tina	tina
tino	tino
tintin	tintini
tirol	tivoli-neu
tirpitz	tirpitz
tito	tito
titov	titov
titus	titus
tjumenin	tjumeni
tobacco	tobacco
tobagon	tobago
tobago	tobago
tobias	tobias
tobin	tobi
tobin	tobin
todd	todd
todellinen	tõeline
todellisen	tõeline
todistajat	tunnistajad
togon	togo
tohtori	doktor
toikka	toikka
toimi	toimi
toinen	teine
toisen	teise
toisessa	teises
toisten	teistel
toivakka	toivakka
toivanen	toivanen
toivola	toivola
toivonen	toivonen
toivo	toivo
tokio	tokio
toki	toki
tokyo	tokyo
tola	tola
tolkien	tolkien
toll	toll
tolsa	tolsa
tolstoi	tolstoi
tomaso	tomaso
tomás	thomaz
tomas	tomas
tomáš	tomáš
tomasz	tomasz
tomislav	tomislav
tomlinson	tomlinson
tommaso	tommaso
tommi	tommi
tommy	tommy
tompkins	tompkins
tomskin	tomski
tone	tone
tongan	tonga
tong	tong
toni	toni
tony	tony
töölön	töölön
tools	tools
toomas	toomas
topelius	topelius
topi	topi
topologia	üldtopoloogia
topologinen	topoloogiline
tora	tora
tore	tore
torinon	torino
torino	torino
tori	tori
törmänen	törmänen
tornio	tornio
torni	torn
törni	törni
torpedo	torpeedo
torre	torre
torso	torso
torsten	torsten
tōru	tōru
torvalds	torvalds
toscanan	toscana
total	total
toto	toto
tottenham	tottenham
totti	totti
tott	tott
touch	touch
toulouse	toulouse
tourer	tourer
touré	touré
tour	tour
tove	tove
towers	towers
tower	tower
townshend	townshend
town	town
toyota	toyota
trace	trace
tractatus	tractatus
tracy	tracy
trade	trade
trafalgarin	trafalgari
trafalgar	trafalgari
transilvanian	transilvanian
transit	transit
transkaukasian	taga-kaukaasia
transparency	transparency
trans	trans
traoré	traoré
trauma	trauma
traveling	traveling
travers	travers
travis	travis
travolta	travolta
treatise	treatise
tree	tree
trenton	trento
trent	trent
tretjakovin	tretjakovi
trey	trey
trianonin	trianoni
tribal	tribal
trier	trier
triesten	trieste
trinidadin	trinidadi
trinidad	trinidad
trio	trio
triple	triple
trip	trip
tristan	tristan
triumph	triumph
triumviraatti	triumviraat
troijan	trooja
trois	trois
tromsø	tromsø
tromssan	tromsø
trondheimin	trondheimi
trooppinen	troopika
trotski	trotski
troyes	troyes
troy	troy
truffaut	truffaut
trujillo	trujillo
trulli	trulli
trumanin	trumani
truman	truman
trump	trump
truth	truth
trygve	trygve
trying	trying
tšadin	tšaadi
tšaikovski	tšaikovski
tšehov	tšehhov
tšekin	tšehhi
tšekkoslovakian	tšehhoslovakkia
tšeljabinskin	tšeljabinski
tšernihivin	tšernigivi
tšernobylin	tšornobõli
tšetšenian	tšetšeeni
tšetšenian	tšetšeenia
tšiang	jiang
tšitan	tšita
tsonga	tsonga
tšudovon	tšudovo
tšukotkan	tšuktši
tšuktšien	tšuktši
tsunami	tsunami
tsushiman	tsushima
tübingenin	tübingeni
tudor	tudor
tuhat	tuhat
tuija	tuija
tuisku	tuisku
tukholman	stockholmi
tukiainen	tukiainen
tulan	tula
tulella	tulega
tuleminen	tulemine
tulimaan	tulemaa
tulio	tulio
tuli	tuli
tulli	toll
tulli	tuļļi
tullius	tullius
tunisian	tuneesia
tunneli	tunnel
tunne	tunne
tunnin	tunni
tunnissa	tunnis
tuntematon	tundmatu
tuomaan	tooma
tuomas	tuomas
tuominen	tuominen
tuomioja	tuomioja
tuomiokirkko	toomkirik
tuorila	tuorila
tuorlan	tuorla
tupac	tupac
tupolev	tupolev
tupou	tupou
tuppurainen	tuppurainen
turbo	turbo
turingin	turingi
turing	turing
turkey	turkey
turkin	türgi
turkish	turkish
turkkilaiset	türklased
turkki	türgi
turkmenistanin	turkmeeni
turkmenistanin	türkmenistani
türk	türk
turnbull	turnbull
turner	turner
turning	turning
turunen	turunen
turun	turu
turvallisuuspolitiikan	julgeolekupoliitika
tusina	tosno
tutte	tutte
tutu	tutu
tuulen	tuulest
tuuli	tuul
tuuli	tuuli
tuulivoima	tuuleenergia
tuulten	tuulepealne
tuure	tuure
tuvalun	tuvalu
tuvan	tõva
tverin	tveri
twain	twain
twenty	twenty
twilight	twilight
twin	twin
twisted	twisted
twist	twist
tyko	tycho
tyler	tyler
tymošenko	tõmošenko
tyne	tyne
tynni	tynni
työn	töö
työ	töö
type	type
typhoon	typhoon
tyra	tyra
tyroksen	tüürose
tyrrell	tyrrell
tyson	tyson
tytär	tütar
tytär	tütred
uderzo	uderzo
udinese	udinese
udmurtian	udmurtia
uefa	uefa
ufan	ufa
ugandan	uganda
ugly	ugly
ukkola	ukkola
ukon	ukon
ukrainan	ukraina
ukraine	ukraine
ulkoasiainministeriö	välisministeerium
ulkoasiainministeri	välisminister
ulkoministeri	välisminister
ulla	ulla
ullmann	ullmann
ulrich	ulrich
ulriika	ulrika
ulrika	ulrika
ulrike	ulrike
ultimate	ultimate
ultima	ultima
ultra	ultra
ulvaeus	ulvaeus
ulysses	ulysses
umar	‘umar
umberto	umberto
understanding	understanding
undertaker	undertaker
underwood	underwood
ungar	ungar
unicefin	unicef-i
unit	unit
unity	unity
universaali	universaalne
universal	universal
universe	universe
university	university
unixin	unixi-laadne
unkarin	ungari
unreal	unreal
unter	unter
uosukainen	uosukainen
uotinen	uotinen
upon	upon
uppsalan	uppsala
upton	upton
uralin	uurali
ural	ural
uranuksen	uraani
urban	urban
urbanus	urbanus
urheilupuisto	urheilupuisto
urho	urho
uriah	uriah
urmas	urmas
urpilainen	urpilainen
ursula	ursula
used	used
uskomattoman	uskumatult
uskonnollinen	usuline
uskontunnustus	usutunnistus
usko	usk
usko	usu
ustinov	ustinov
utahin	utah'
utah	utah
utrecht	utrecht
utrio	utrio
uttar	uttar
uudenkaupungin	uusikaupunki
uudenmaan	uusimaa
uuden	uue
uudet	uued
uuno	uuno
uusi-seelanti	uus-meremaa
uusi	uus
uusivirta	uusivirta
uutiset	uutiset
uzbekistanin	usbeki
uzbekistanin	usbekistani
vaalipiiri	valimisringkond
vaalit	valimised
vaasan	vaasa
vaasa	vaasa
vaasa	vasa
václav	václav
vader	vader
vadim	vadim
vadstenan	vadstena
vähentäminen	vähendamine
vähiten	vähimarenenud
vaino	vaino
väinö	väinö
väisälä	väisälä
väkevä	väkevä
vakhtang	vahtang
väkivalta	vägivald
valamon	valamo
vala	vala
valdain	valdai
valdemar	valdemar
valdés	valdés
valdez	valdez
valencia	valencia
valentina	valentina
valentine	valentinipäev
valentinianus	valentinianus
valentino	valentino
valera	valera
valerian	valerian
valeria	valeria
valerie	valerie
valerius	valerius
valeri	valeri
valéry	valéry
vale	vale
välimeren	vahemere
valinnan	valiku
valio	valio
valistus	valgustusajastu
väli	väli
valkama	valkama
valkeapää	valkeapää
valkoinen	valge
valkonen	valkonen
valko-venäjän	valgevene
valkyrie	"valküür"
valkyrie	valkyrie
valladolidin	valladolidi
valladolid	valladolidi
valle	valle
valley	valley
vallgren	vallgren
valli	vall
valloittaja	vallutaja
valon	valon
valo	valo
valtaus	vallutamine
valter	valter
valtiovarainministeriö	rahandusministeerium
valtteri	valtteri
valuuttarahasto	valuutafond
valve	valve
vampire	vampire
vampyyri	vampiir
vance	vance
vancouver	vancouver
vanderbiltin	vanderbilti
vanderbilt	vanderbilt
vanessa	vanessa
vangin	vangi
vanhanen	vanhanen
vanhasen	vanhaneni
vanha	vana
vanhempi	vanem
vanhus	vanamees
vanilla	vanilla
vanity	vanity
vankeus	vangistus
vankila	vangla
vanki	vang
vapaana	vabana
vapaat	vaba
vapaat	vabad
vapaa	vaba
vapaa	vabade
vapaavuori	vapaavuori
vapauden	vabaduse
vapaussodan	vabadussõja
vapaussota	vabadussõda
vapaus	vabadus
vapautusrintama	vabastusrinne
vappu	vappu
vara	vara
varela	varela
vares	vares
vargas	vargas
varg	varg
varjot	varjud
varjo	vari
varkaiden	varaste
varkauden	varkause
värmlannin	värmlandi
varnan	varna
vasara	vasar
vasara	vasara
vasari	vasari
vasa	vasa
vasco	vasco
vasikka	kuldvasikas
vasili	vassili
vasiljev	vassiljev
vastaan	vastu
vastainen	vastane
västerbottenin	västerbotteni
västernorrlandin	västernorrlandi
västmanlandin	västmanlandi
vatanen	vatanen
vatikaanin	vatikani
vatjan	vadja
vaughan	vaughan
väyrynen	väyrynen
vázquez	vázquez
vedessä	vees
vedet	veed
vegas	vegas
vega	vega
vehviläinen	vehviläinen
veijonen	veijonen
veijo	veijo
veikko	veikko
veil	veil
velasco	velasco
vela	vela
vélez	vélez
velikije	velikije
veliki	veliki
veli	veli
vella	vella
veltto	veltto
velvet	velvet
venäjälle	venemaale
venäjän-japanin	vene-jaapani
venäjänkielinen	venekeelne
venäläinen	vene
venäläiset	venelased
vendéen	vendéen
venera	venera
venetsian	veneetsia
venetsian	veneta
venetsiassa	veneetsias
venetsia	veneetsia
venetsia	venezia
vene	vene
venezuelan	venezuela
vengeance	vengeance
vennamo	vennamo
ventspilsin	ventspilsi
venuksen	veenuse
venuksen	venuse
venus	venus
vepsän	vepsa
vera	vera
verenkierto	vereringe
veren	vere
vergne	vergne
verhnjaja	verhnjaja
veritas	veritas
veritas	veritase
verkko	võrk
vermeer	vermeer
verne	verne
veronan	verona
verona	verona
veronica	veronica
veronika	veronika
version	versioon
verstappen	verstappen
vertaileva	võrdlev
verve	verve
vesala	vesala
vesa-matti	vesa-matti
vesa	vesa
vesitie	veetee
vesi	vesi
vestan	vesta
vettel	vettel
viasat	viasat
vicious	vicious
vicky	vicky
victorian	victoria
victoria	victoria
vidal	vidal
vida	vida
vieira	vieira
vieri	vieri
vietnamin	vietnami
vietnam	vietnam
view	view
viggo	viggo
vigo	vigo
vihtori	vihtori
viides	viies
viii	viii
viimeinen	viimane
viinit	veinid
viipurin	viiburi
viisiottelu	viievõistlus
viisi	viie
viisi	viis
viittomakieli	viipekeel
viive	viive
viivi	viivi
vikernes	vikernes
viking	viking
viktoria	viktorija
viktor	viktor
viktoryja	viktoryja
vila	vila
vilen	vilen
vilhelm	vilhelm
vilhelm	willem
viljo	viljo
villarreal	villarreal
villa	villa
villeneuve	villeneuve
vincent	vincent
vincenzo	vincenzo
vincin	fiumicino
vinci	vinci
vino	vino
viola	viola
violeta	violeta
violetta	violetta
violet	violet
virén	virén
virginia	virginia
virkkunen	virkkunen
virolainen	virolainen
virpi	virpi
virtanen	virtanen
virtaranta	virtaranta
virta	virta
virtual	virtual
virus	viirus
virve	virve
vista	vista
visual	visual
vitali	vitali
vita	vita
vitebskin	vitebski
vito	vito
vitro	vitro
vitsebskin	viciebski
vittorio	vittorio
vitus	vitus
viulunsoittaja	viiuldaja
vivaldi	vivaldi
vivian	vivian
vivien	vivien
vivo	vivo
vjatkan	vjatka
vjatšeslav	vjatšeslav
vladimirin	vladimiri
vladimir	vladimir
vladimír	vladimír
vlad	vlad
vodka	vodka
voitto	võit
voivodikunta	vojevoodkond
voldemar	voldemar
volgan	volga
volgogradin	volgogradi
volkov	volkov
volkswagen	volkswagen
volk	volk
vologdan	vologda
volossovan	volossovo
volta	volta
volvo	volvo
volynian	volõõnia
vonnegut	vonnegut
voronežin	voroneži
voss	voss
vostok	vostok
voutilainen	voutilainen
voyager	voyager
vries	vries
vsevolod	vsevolod
vuorinen	vuorinen
vuoristo-karabahin	mägi-karabahhi
vuosaaren	vuosaari
vyšni	võšni
vysoké	vysoké
vytautas	vytautas
waalsin	waalsi
wade	wade
wadi	wadi
wagner	wagner
wahlberg	wahlberg
wahl	wahl
wäinö	wäinö
waits	waits
wake	wake
walcott	walcott
waldemar	waldemar
waldheim	waldheim
waldo	waldo
wałęsa	wałęsa
wales	wales
walker	walker
walk	walk
wallace	wallace
wallander	wallander
wallenberg	wallenberg
wallenius	wallenius
waller	waller
wallinheimo	wallinheimo
wallis	wallis
wall	wall
walpole	walpole
walrus	walrus
walsh	walsh
waltari	waltari
walters	walters
walter	walter
walther	walther
walton	walton
walt	walt
waltz	waltz
wanderers	wanderers
wang	wang
wanna	wanna
wannseen	wannsee
wanted	wanted
warcraft	warcraft
ward	ward
warhol	warhol
waris	waris
warner	warner
warp	warp
warrenin	warreni
warren	warren
warriors	warriors
warrior	warrior
wars	wars
warwickin	warwicki
warwick	warwick
washingtonin	washingtoni
washington	washington
watanabe	watanabe
watch	watch
waterloon	waterloo
waterloo	waterloo
waters	waters
water	water
watford	watford
watterson	watterson
watts	watts
watt	watt
waugh	waugh
wawrinka	wawrinka
waylon	waylon
waynen	wayne'i
wayne	wayne
wear	wear
weasleyn	weasley
weasley	weasley
weaver	weaver
webber	webber
webb	webb
webb	webbi
webern	webern
weber	weber
weekend	weekend
week	week
wehrmacht	wehrmacht
weil	weil
weimarin	weimari
weinberg	weinberg
weir	weir
weiss	weiss
welker	welker
welles	welles
welling	welling
wells	wells
welsh	welsh
welt	welt
wembley	wembley
wendell	wendell
wenger	wenger
wenzel	wenzel
werner	werner
wernher	wernher
wesley	wesley
wessel	wessel
westerberg	westerberg
westermarck	westermarck
westfalenin	vestfaali
westminster	westminster
westö	westö
west	west
westwood	westwood
whistlerin	whistleri
whistler	whistler
whitaker	whitaker
white	white
whitfield	whitfield
whitman	whitman
whitney	whitney
whittaker	whittaker
wicked	wicked
wide	wide
wieland	wieland
wiener	wiener
wienin	viini
wien	wien
wiesenthal	wiesenthal
wiesenthal	wiesenthali
wigan	wigan
wiggins	wiggins
wiggum	wiggum
wiik	wiik
wikimedia	wikimedia
wikipedia	vikipeedia
wilder	wilder
wilde	wilde
wild	wild
wiley	wiley
wilfred	wilfred
wilhelmsson	wilhelmsson
wilhelm	wilhelm
wilkes	wilkes
wilkins	wilkins
willard	willard
willem	willem
wille	wille
williamin	williami
williamsin	williamsi
williams	williams
william	william
willie	willie
willis	willis
willi	willi
wills	wills
will	will
willy	willy
wilma	wilma
wilsonin	wilsoni
wilson	wilson
wimbledonin	wimbledoni
wimbledon	wimbledon
windows	windows
window	window
windsorin	windsori
windsor	windsor
winehouse	winehouse
winfrey	winfrey
winkler	winkler
winner	winner
winona	winona
winston	winston
winters	winters
winter	winter
wirkkala	wirkkala
wisconsinin	wisconsini
wisconsin	wisconsin
witherspoon	witherspoon
within	within
witten	witten
witte	witte
wittgenstein	wittgenstein
wivi	wivi
wizards	wizards
wladimir	wladimir
władysław	władysław
wojciech	wojciech
woldemar	woldemar
wolfenstein	wolfenstein
wolfe	wolfe
wolff	wolff
wolfgang	wolfgang
wolfram	wolfram
wolfsburg	wolfsburg
wolf	wolf
wolverhampton	wolverhampton
wolverine	wolverine
womack	womack
woman	woman
wonderland	wonderland
wonder	wonder
woodrow	woodrow
woods	woods
woodward	woodward
wood	wood
woody	woody
woolf	woolf
work	work
worlds	worlds
world	world
worship	worship
worth	worth
wozniacki	wozniacki
wrangel	wrangel
wrangel	wrangell
wright	wright
wulff	wulff
wuolijoki	wuolijoki
wuori	wuori
württembergin	württembergi
würzburgin	würzburgi
wurz	wurz
wyndham	wyndham
xavier	xavier
xbox	xbox
xerox	xerox
xiii	xiii
xviii	xviii
xvii	xvii
xxiii	xxiii
xxii	xxii
yahya	yahya
yahya	yaḩyá
yamaguchi	yamaguchi
yamamoto	yamamoto
yankees	yankees
yannick	yannick
yann	yann
yardbirds	yardbirds
yard	yard
year	hea
yellowstonen	yellowstone'i
yesterday	yesterday
yhdeksäs	üheksas
yhdelle	ühele
yhdistäminen	aheldamine
yhdistyminen	ühendamine
yhdistyminen	ühinemine
yhteinen	ühine
yhteiskunta	ühiskond
yhtenäinen	ühtne
yksinäinen	üksildane
yksin	üksinda
yksi	üks
ylikangas	ylikangas
yliopistollinen	ülikooli
ylönen	ylönen
ylppö	ylppö
yokohama	yokohama
yorker	yorker
yorke	yorke
yorkin	yorgi
yorkshire	lääne-yorkshire
yorkshire	põhja-yorkshire
york	yorgi
york	york
yoshida	yoshida
yoshiyuki	yoshiyuki
youngin	youngi
young	young
youth	youth
yrjänä	yrjänä
yrjö	yrjö
ystadin	ystadi
yuan	yuan
yukio	yukio
yukon	yukon
yunus	yunus
yuri	yuri
yusuf	yuusuf
yves	yves
zachary	zachary
zachris	zacharias
zach	zach
zagrebin	zagrebi
zaitsev	zaitsev
zappa	zappa
zaragoza	zaragoza
zarathustra	zarathustra
zara	zara
zbigniew	zbigniew
ždanov	ždanov
zdeněk	zdeněk
zealand	zealand
zedong	zedong
zeiss	zeiss
zeitung	zeitung
zellweger	zellweger
zelmerlöw	zelmerlöw
zeman	zeman
zemlja	zemlja
zenon	zenon
zeppelin	zeppelin
zetterberg	zetterberg
zeuksen	zeusi
zhang	zhang
zhao	zhao
zheng	zheng
zhou	zhou
zidane	zidane
ziegler	ziegler
ziggy	ziggy
zilliacus	zilliacus
zimmer	zimmer
zinédine	zinédine
zinn	zinn
zlatan	zlatan
zogu	zog
zola	zola
zoltán	zoltán
zombie	zombie
zone	zone
zoran	zoran
zornin	zorni
zorn	zorn
zoro	zoro
žukov	žukov
zulun	suulu
zürichin	zürichi
zwingli	zwingli
