abandon	abbandono
abandonné	abbandonato
abandonnée	abbandonata
abandonnées	abbandonate
abandonnent	abbandona
abandonner	abbandonare
abattue	abbattuta
aboli	abolita
abolie	abolita
abondant	abbondante
abonnements	abbonamenti
abrogé	abrogato
absence	assente
absente	assenza
absentes	assenti
absolue	assoluta
absolument	assolutamente
absorbe	assorbita
absorbé	assorbita
absorbent	assorbono
absorber	assorbire
absorbés	assorbite
absorption	assorbimento
abstrait	astratto
abstraites	astratte
absurde	assurdo
absurdes	assurde
abusif	abusivo
académie	accademia
académies	accademie
académique	accademica
académiques	accademiche
accélère	accelera
accéléré	accelerato
accélérer	accelerare
accent	accento
acceptable	accettabile
acceptables	accettabili
acceptant	accettando
acceptant	accettazione
acceptation	accettazione
accepte	accetta
accepté	accettato
acceptée	accettata
acceptées	accettate
accepter	accettare
accessibilité	accessibilità
accessible	accessibile
accessibles	accessibile
accessoires	accessori
accident	accidentale
accidentelle	accidentale
accident	incidente
accidents	incidente
accidents	incidenti
accord	accordo
accords	accordi
accrédité	accreditato
accumulation	accumulo
accumule	accumulano
accumulé	accumulati
accumulée	accumulati
acides	acidi
actes	fatti
acteur	attore
acteurs	attori
actif	attivazione
actifs	attivi
action	azione
action	azioni
actionnaire	azionista
actionnaires	azionisti
activation	attivata
active	attiva
activé	attivo
activée	attivato
activer	attivare
actives	attive
activiste	attivista
activité	attività
actrice	attrice
actualité	attualità
actuel	attuale
actuelle	attuale
actuelles	attuali
adapté	adattati
adaptée	adattata
adaptées	adattate
adapter	adattare
adhérer	aderire
admet	ammette
administrateurs	amministratori
administration	amministrazione
administrative	amministrativa
administratives	amministrative
administré	amministrato
administrées	amministrati
admiration	ammirazione
admiré	ammirata
admises	ammesse
admission	ammissione
adolescence	adolescenza
adolescents	adolescenti
adopte	adotta
adopté	adottata
adoptée	adottata
adoptées	adottate
adopter	adottare
adoption	adozione
adriatique	adriatica
adulte	adulta
adulte	adulto
adultère	adulterio
adultes	adulti
adversaire	avversario
adversaires	avversari
aériennes	aeree
aéronautique	aeronautica
aéroport	aeroporto
aéroport	aeroportuale
aéroports	aeroporti
affiliées	affiliate
affinité	affinità
affirmation	affermazione
affirme	afferma
affirmer	affermare
affluents	affluenti
africain	africano
africaine	africana
africains	africani
agence	agenzia
agence	agenzie
agences	agenzie
agent	agente
agents	agenti
aggravé	aggravato
agité	agitato
agressifs	aggressivi
agression	aggressione
agressions	aggressioni
agressive	aggressiva
agressive	aggressive
agressivité	aggressività
agricole	agricola
agricole	agricolo
agricoles	agricola
agriculteurs	agricoltori
agriculture	agricoltura
alarme	allarme
albanais	albanesi
alcool	alcol
alcoolisées	alcoliche
alerte	allerta
algérien	algerino
algorithme	algoritmo
algues	alghe
alimentaire	alimentare
alimentaire	alimentari
alimentation	alimentazione
alimenté	alimentato
alimentés	alimentati
aliments	alimentare
aliments	alimenti
alliances	alleanze
allié	alleato
alliées	alleate
alpine	alpina
alpines	alpino
alternative	alternativa
alternatives	alternativa
aluminium	alluminio
amateur	amatoriale
ambassade	ambasciata
ambassadeur	ambasciatore
ambassadeurs	ambasciatori
ambigu	ambigua
ambitieuse	ambiziosa
ambitieux	ambizioso
ambition	ambizione
ambitions	ambizioni
amendement	emendamenti
amendements	emendamento
amère	amara
américain	americana
américain	americano
américaine	americana
amnistie	amnistia
amont	monte
amphibies	anfibi
analyse	analisi
analyste	analista
analystes	analisti
analytique	analitica
analytiques	analitiche
anarchie	anarchia
ancestrales	ancestrali
ancré	ancorato
anecdotes	aneddoti
anglo-saxonnes	anglosassoni
animal	animale
animale	animale
animaux	animali
animé	animato
animés	animati
anniversaire	anniversario
annuaire	annuario
annuel	annuale
annuelle	annuale
annulé	annullata
annulé	annullato
annuler	annullare
anomalies	anomalie
anonyme	anonimo
anonymes	anonimi
anormale	anomala
antennes	antenne
antibiotiques	antibiotici
anticipant	anticipando
anticipé	anticipato
anticommuniste	anticomunista
antidote	antidoto
antique	antica
antisémite	antisemita
antisémitisme	antisemitismo
appareil	apparato
apparent	apparente
apparentes	apparenti
appartement	appartamento
appartements	appartamenti
appartenait	apparteneva
appartenance	appartenenza
appartient	appartiene
appel	appello
appels	appelli
applicable	applicabile
applicables	applicabile
applications	applicazioni
appliquer	applicare
apprécie	apprezza
apprécié	apprezzato
apprécier	apprezzare
approbation	approvazione
approfondi	approfondito
approfondies	approfondite
approfondir	approfondimento
approuver	approvare
approvisionnement	approvvigionamenti
approvisionnement	approvvigionamento
approximative	approssimativa
arabe	arabo
arabes	araba
arbitrage	arbitrale
arbitraire	arbitraria
arbitre	arbitro
arbitres	arbitri
archaïque	arcaica
archéologique	archeologica
archéologique	archeologico
archéologiques	archeologici
archipel	arcipelago
architecte	architetto
architecturale	architettonica
architecture	architettura
archive	archivio
archives	archivi
arctique	artica
arctique	artico
argentin	argentino
argentine	argentina
argentines	argentine
arguments	argomentazioni
arithmétique	aritmetica
armé	armato
armées	armati
armement	armamenti
arménien	armeni
aromatiques	aromatici
arrestations	arresti
arrogant	arrogante
arsenal	arsenale
art	arte
artères	arterie
artérielle	arteriosa
article	articolo
articles	articoli
articulés	articolati
artificiel	artificiale
artificielle	artificiali
artillerie	artiglieria
artisanales	artigianali
artisanat	artigiane
artiste	artista
artistes	artisti
artistique	artistica
artistique	artistiche
artistique	artistico
asiatique	asiatica
asiatique	asiatiche
asiatique	asiatico
aspects	aspetti
aspiration	aspirazione
aspirations	aspirazioni
aspire	aspira
assassin	assassino
assassinat	assassinato
assassinat	assassinio
assassiner	assassinio
assassins	assassini
assembler	assemblate
assimilation	assimilazione
assimilé	assimilato
assistance	assistente
assistant	assistente
assistant	assistenza
assiste	assiste
assisté	assistito
assister	assistere
association	associare
association	associazione
associations	associazioni
associé	associata
associé	associato
associées	associate
associent	associano
assume	assume
assumer	assumerà
assumer	assumere
assurance	assicurazione
assurant	assicurando
assurer	assicurare
assyriens	assiri
astronaute	astronauta
astronomique	astronomica
astronomiques	astronomica
asymétrique	asimmetrica
asymétriques	asimmetriche
atlantique	atlantica
atlantique	atlantiche
atmosphère	atmosfera
atmosphérique	atmosferiche
atomique	atomica
atomiques	atomiche
atrocités	atrocità
attaques	attacchi
attention	attenzione
atténuer	attenuare
attire	attirare
attractif	attraente
attribuée	attribuita
attribuées	attribuite
attribut	attributo
attributs	attributi
audience	audience
auspices	auspici
australien	australiano
australiennes	australiani
auteur	autore
auteure	autore
authenticité	autenticità
authentique	autentica
authentiques	autentiche
autobus	autobus
autochtones	autoctone
automatique	automatica
automatique	automatiche
automatique	automatico
automobile	automobilistico
automobiles	automobili
autonome	autonoma
autonome	autonomo
autonomes	autonomi
autonomie	autonomia
autorisation	autorizzazione
autorise	autorizza
autorisé	autorizzato
autorisée	autorizzata
autorisées	autorizzate
autoritaire	autoritaria
autoritaire	autoritario
autorité	autorità
autorités	autorità
autrichien	austriaco
autrichiens	austriache
autrichiens	austriaci
auxiliaire	ausiliaria
auxiliaires	ausiliarie
avancé	avanzata
avancés	avanzate
avantages	vantaggiosa
avantageuse	vantaggioso
avantageux	vantaggio
avantage	vantaggi
avant-garde	avanguardia
avant-poste	avamposto
aventure	avventura
aventures	avventure
avertissement	avvertimento
avocat	avvocato
avocats	avvocati
avril	aprile
bactérie	batteri
bactérie	batterio
bactérienne	batteriche
bactéries	batteri
bagages	bagagli
baleine	balena
balistiques	balistici
baltes	baltici
banale	banale
bancaire	bancaria
bancaire	bancarie
bancaire	bancario
bande	banda
banquet	banchetto
banquier	banchiere
barbare	barbara
barbares	barbara
barons	baroni
barrières	barriere
bassin	bacino
batteries	batteria
batteries	batterie
bavarois	bavarese
belge	belga
belges	belgi
bénéfice	beneficio
bénéfices	benefici
bénéficiaire	beneficiario
bénéficié	beneficiato
bénéficier	beneficiare
bible	bibbia
bibliothèque	biblioteca
bibliothèques	biblioteche
biblique	biblico
bibliques	bibliche
bicyclette	bicicletta
bicyclettes	biciclette
biélorusse	bielorusso
bilatérale	bilaterale
bilatérales	bilaterali
bilingue	bilingue
billet	biglietto
biochimiques	biochimico
biodiversité	biodiversità
biographies	biografia
biologique	biologica
biologique	biologiche
biologique	biologico
biosphère	biosfera
biotechnologies	biotecnologie
bizarre	bizzarra
bizarre	bizzarre
blocage	bloccare
blocs	blocchi
bombardé	bombardata
bombardement	bombardamenti
bombardement	bombardamento
bombardements	bombardamenti
bombe	bomba
bombes	bombe
bosniaque	bosniaca
bosniaque	bosniaco
bouddhisme	buddismo
bouddhiste	buddista
bourgeois	borghesi
bourgeoisie	borghesia
bourse	borsa
bourses	borse
bouton	bottone
bovins	bovini
bovins	bovino
boycott	boicottaggio
brésilien	brasiliano
brésiliennes	brasiliane
brésiliens	brasiliani
brevet	brevetto
brevets	brevetti
brigade	brigata
britannique	britannica
britannique	britannico
britanniques	britanniche
britanniques	britannici
brutal	brutale
brutalement	brutale
brutales	brutali
brutalité	brutalità
brute	bruta
bulgare	bulgara
bulgare	bulgaro
bulgares	bulgara
buste	busto
cabine	cabina
cabinet	gabinetto
cadastre	catasto
cadavres	cadaveri
café	caffè
calcul	calcolo
calcule	calcola
calculé	calcolato
calculée	calcolata
calculées	calcolate
calculer	calcolare
calculer	calcolo
calculs	calcoli
calendrier	calendario
calendriers	calendari
calibre	calibro
calme	calma
camions	camion
campagne	campagna
campagnes	campagne
campus	campus
canadien	canadese
canadienne	canadese
canadiens	canadesi
canal	canale
canalisation	incanalare
canaux	canali
cancer	cancro
candidat	candidato
candidats	candidati
candidature	candidatura
canon	canonico
canonique	canonico
canton	cantone
capable	capace
capables	capaci
capacité	capacità
capitaine	capitano
capital	capitale
capital	capitali
capitale	capitale
capitales	capitali
capitaliste	capitalista
capitalistes	capitalista
capitaux	capitale
capitulation	capitolazione
captage	cattura
captivité	cattività
capture	cattura
capture	catturare
capturé	catturato
capturer	catturare
caractère	carattere
caractérisent	caratterizzate
caractéristique	caratteristica
caractéristiques	caratteristiche
carbone	carbonio
carcasses	carcasse
cardiaque	cardiaca
cardiaque	cardiaco
caricature	caricatura
caritatives	carità
carrière	carriera
carrière	carriere
carte	cartina
cartésien	cartesiano
casino	casinò
caste	casta
catalan	catalana
catalan	catalano
catalogue	catalogo
catastrophe	catastrofe
catastrophe	catastrofi
catastrophique	catastrofica
catégorie	categoria
catégories	categorie
cathédrale	cattedrale
catholicisme	cattolicesimo
catholique	cattolica
catholique	cattoliche
catholique	cattolico
catholiques	cattolici
cause	causa
causes	cause
ceintures	cinture
cellule	cellula
cellules	cellule
celtique	celtica
censure	censura
censuré	censurata
centenaire	centenario
centrale	centrale
centrales	centrali
centralisé	centralizzato
centralisée	centralizzata
centre	centro
centre-droit	centro-destra
centrée	centrata
centres	centri
cercle	cerchia
céréales	cereali
cérébral	cerebrale
cérébrales	cerebrali
cérémonie	cerimonia
certificat	certificato
certification	certificazione
certificats	certificati
certificats	certificato
certitude	certezza
chambres	camere
champagne	champagne
champion	campione
championnat	campionato
championnats	campionati
championne	campione
champions	campioni
chancelier	cancelliere
chantier	cantiere
chaotique	caotica
chaotique	caotico
chapitre	capitolo
chapitres	capitoli
charrue	carro
chaud	caldo
chiffre	cifra
chiffres	cifre
chilien	cileno
chimie	chimica
chimique	chimica
chimiques	chimiche
chimiste	chimico
chinois	cinese
chinois	cinesi
chinoise	cinese
chinoises	cinesi
chirurgicales	chirurgia
chirurgien	chirurgo
chlorure	cloruro
chocolat	cioccolato
choléra	colera
cholestérol	colesterolo
chrétien	cristiano
chrétienne	cristiane
chrétiens	cristiani
chromatique	cromatica
chromosomes	cromosomi
chronique	cronica
chroniques	croniche
chronologique	cronologico
chypriote	cipriota
ciment	cemento
cimetière	cimitero
cimetières	cimiteri
circonscription	circoscrizione
circonscriptions	circoscrizioni
circonstances	circostanze
circuit	circuito
circuits	circuiti
circulaire	circolare
circulation	circolazione
circule	circola
circuler	circolare
cirque	circo
citadelle	cittadella
citation	citando
citent	citano
civile	civile
civiles	civili
civils	civili
civique	civica
civique	civiche
civique	civico
claires	chiare
classe	classe
classes	classi
classification	classificare
classifications	classificazioni
classique	classica
classique	classico
classiques	classiche
clause	clausola
clause	clausole
clergé	clero
client	cliente
client	clienti
clients	clienti
climat	clima
climatique	climatici
clinique	clinica
clinique	cliniche
clinique	clinico
cliniques	cliniche
clones	cloni
coalition	coalizione
coauteur	coautore
cocaïne	cocaina
codification	codificare
codification	codificazione
codifié	codificato
cognitif	cognitivo
cognitives	cognitivi
cohérent	coerente
cohérente	coerente
cohérente	coerenti
coïncidence	coincidenza
coïncident	coincidono
collaborateur	collaboratore
collaboration	collaborazione
collaboré	collaborato
collaborer	collaborare
collatéraux	collaterali
collective	collettiva
collective	collettive
collègue	collega
collision	collisione
colombien	colombiano
colonel	colonnello
coloniale	coloniale
coloniales	coloniali
colonies	colonie
colonies	colonizzazione
colonisation	colonizzazione
colonne	colonna
coloré	colorato
combattent	combattono
combattre	combattere
combattu	combattuta
combinaison	combinazione
combinant	combinando
combine	combina
combiné	combinato
combinée	combinata
combiner	combinare
combiner	combinazione
combustible	combustibile
combustibles	combustibili
comestibles	commestibile
comestibles	commestibili
comité	comitato
comités	comitati
comités	commissioni
commandant	comandante
commandé	commissionate
commandos	commando
commémoration	commemorativa
commémoration	commemorazione
commémore	commemora
commémoré	commemorato
commentaire	commento
commentaires	commenti
commentateur	commentatore
commentateurs	commentatori
commenté	commentato
commerçant	commerciante
commerçants	commercianti
commerce	commercio
commerciale	commerciale
commerciale	commerciali
commercialisation	commercializzazione
commercialisés	commercializzati
commet	commette
commettre	commettere
commis	commesso
commises	commesse
commissaire	commissario
commissaires	commissari
commission	commissione
commissions	commissioni
communautaire	comunitaria
communautaire	comunitarie
communautaire	comunitario
communauté	comunità
commun	comune
commune	comune
commune	comuni
communication	comunicazione
communications	comunicazioni
communiqué	comunicato
communiquent	comunicano
communiquer	comunicare
communisme	comunismo
communiste	comunista
compagnie	compagnia
compagnies	compagnie
comparable	comparabile
comparables	comparabili
comparative	comparativa
comparé	comparato
comparer	comparazione
compassion	compassione
compatibilité	compatibilità
compatible	compatibile
compatibles	compatibili
compendium	compendio
compensation	compensazione
compenser	compensare
compétence	competente
compétence	competenza
compétences	competenti
compétences	competenze
compétent	competente
compétente	competenza
compétentes	competenze
compétitif	competitivo
compétitive	competitivi
complémentaire	complementare
complémentaires	complementari
complément	complemento
complète	completa
complété	completato
complète	completi
complétée	completata
complètement	completamente
compléter	completare
complexe	complessa
complexes	complesse
complexité	complessità
complications	complicazioni
complices	complicare
complicité	complicità
complique	complica
compliqué	complicata
compliquées	complicati
comportementale	comportamentale
comportement	comportamenti
comportements	comportamenti
comporter	comportarsi
composante	componente
composantes	componenti
composé	composto
composées	composti
composent	compongono
compositeur	compositore
compositeurs	compositori
comprend	comprende
compromettre	compromettere
compromis	compromessi
compromis	compromesso
comptabilité	contabilità
comptable	contabile
comptable	contabili
comte	conte
concentrant	concentrandosi
concentration	concentrazione
concentrations	concentrazioni
concentre	concentra
concentré	concentrata
concentrée	concentrata
concentrées	incentrate
concentrer	concentrare
concept	concetto
concepts	concetti
conceptuel	concettuale
concessions	concessioni
concilier	conciliare
conclure	conclusione
conclusion	conclusione
conclusions	conclusioni
concours	concorso
concrets	concreti
conçu	concepito
conçues	concepite
concurrence	concorrenza
concurrent	concorrente
concurrentes	concorrenti
concurrents	concorrenti
condamnation	condanna
condamnations	condanne
condamne	condanna
condamné	condannato
condamnée	condannata
condamner	condanna
condamner	condannare
condamnés	condannati
condition	condizione
conditionné	condizionato
conditions	condizioni
conduite	condotta
confère	conferisce
conféré	conferito
conférence	conferenza
conférences	conferenze
confessions	confessioni
confirmant	confermando
confirmation	conferma
confirme	conferma
confirme	confermare
confirmé	confermato
confirmée	confermata
confirmées	confermate
confirmer	confermare
confiscation	confisca
confisqués	confiscati
conflit	conflitto
conflits	conflitti
confond	confonde
confondu	confusa
confondu	confuso
confondus	confuse
conformément	conformità
conformes	conformi
confortable	confortevole
confort	comfort
confrontation	confronto
confrontation	scontri
confusion	confusione
conglomérat	conglomerato
congrégations	congregazioni
congrès	congresso
connectivité	connettività
connexion	connessioni
connexions	connessioni
connotation	connotati
consécutif	consecutiva
consécutive	consecutiva
consécutives	consecutivi
conseil	consiglio
conseil	consulenza
conseiller	consigliere
conseillers	consiglieri
conseils	consigli
consensus	consenso
conservateur	conservatore
conservation	conservazione
conservatrice	conservatori
conserves	conserva
considérable	considerevole
considérables	considerevoli
considération	considerazione
considérations	considerazioni
considère	considera
considéré	considerata
considérées	considerati
considérons	consideriamo
consiste	consiste
consolidation	consolidamento
consolidé	consolidato
consolider	consolidare
consommateur	consumatore
consommateurs	consumatori
consomme	consuma
consommé	consumato
consommée	consumati
consommer	consumare
conspirateurs	cospiratori
constamment	costante
constante	costante
constantes	costanti
constaté	constatato
constatées	riscontrate
constitue	costituisce
constituer	costituirà
constitués	costituiti
constitutionnel	costituzionale
constitutionnelle	costituzionale
constitutionnelles	costituzionali
constructive	costruttiva
constructive	costruttivo
construire	costruire
construisant	costruendo
construisent	costruendo
construit	costruisce
construite	costruita
construites	costruite
consulaires	consolare
consulat	consolato
consul	console
consultants	consulenti
consultatif	consultivo
consultation	consultazione
consulté	consultato
consulter	consultare
contact	contatti
contacté	contattato
contacter	contattare
contacts	contatti
contacts	contatto
contamination	contaminazione
contaminées	contaminati
contemporain	contemporaneo
contemporaine	contemporanea
contemporains	contemporanei
contenait	conteneva
conteneurs	container
contenu	contenuti
conteste	contesta
contesté	contestato
contestée	contestata
contexte	contesto
contextes	contesti
contient	contiene
continental	continentale
continentale	continentale
continent	continente
continents	continenti
continuant	continuando
continu	continuo
continue	continua
continué	continuato
continuera	continuare
continuer	continuare
continuité	continuità
contractuelles	contrattuali
contradiction	contraddizione
contradictions	contraddizioni
contradictoire	contraddittorio
contradictoires	contraddittorie
contraire	contrariamente
contraires	contrarie
contraste	contrasta
contrat	contratto
contrats	contratti
contre-attaque	contrattacco
contre-attaques	contrattacchi
contrebande	contrabbando
contre-espionnage	controspionaggio
contribue	contribuire
contribué	contribuito
contribuer	contribuire
contribution	contributo
contributions	contributi
contrôlé	controllata
contrôle	controllo
contrôlée	controllata
contrôlée	controllate
contrôler	controllare
controverse	controversa
controversé	controversa
controverse	controverse
contumace	contumacia
convaincant	convincente
convaincante	convince
convaincre	convincere
convaincu	convinto
convaincue	convinta
convaincus	convinti
conventionnel	convenzionale
conventionnelles	convenzionali
conventions	convenzioni
convenu	convenuto
convergence	convergente
convergence	convergenza
convergente	convergenza
conversation	conversazione
conversion	conversione
conviction	convinzione
convocation	convocare
convoi	convoglio
convoqué	convocato
coopération	cooperazione
coopérer	cooperare
coordinateur	coordinatore
coordination	coordinamento
coordonne	coordina
coordonné	coordinata
coordonnée	coordinata
coordonnée	coordinate
coordonner	coordinare
copié	copiato
copier	copiare
copies	copie
copte	copta
cordon	cordone
coréen	coreana
coréen	coreano
coréenne	coreana
coréens	coreani
cornes	corna
corporel	corporale
corps	corpo
correcte	corretta
correctement	corretta
correctes	corrette
correction	correzione
correspondait	corrispondeva
correspondance	corrispondenza
correspond	corrisponde
correspondent	corrispondono
correspondre	corrispondere
corridor	corridoio
corridors	corridoi
corruption	corruzione
cosmétiques	cosmetici
cosmopolite	cosmopolita
costume	costume
cotées	quotate
courant	corrente
courbe	curva
courbure	curvatura
couronne	corona
couronnes	corone
courses	corse
coût	costo
coûte	costa
couvert	coperta
couverte	coperta
couvertes	coperte
couverture	copertura
couverture	coprire
couvre	coprire
créateur	creatore
créative	creativa
créatives	creativa
créativité	creatività
créature	creatura
créatures	creature
crédibilité	credibilità
crédible	attendibili
crédible	credibile
crédit	crediti
crédit	credito
crédits	crediti
créer	creare
crime	crimine
crimes	crimini
criminel	criminale
criminelle	criminale
criminelles	criminali
crise	crisi
critère	criterio
critères	criteri
critique	critica
critiqué	criticato
critique	critiche
critiquées	criticati
critiquer	criticare
critiques	critiche
croate	croato
croates	croata
croates	croati
crocodile	coccodrillo
croisade	crociata
croisade	crociate
croix	croci
cruciale	cruciale
cruel	crudele
crustacés	crostacei
cubain	cubano
cubaine	cubana
culminant	culminata
culte	culto
cultivé	coltivato
cultivées	coltivate
cultivent	coltiva
cultiver	coltivare
culture	cultura
culture	culture
culturel	culturale
culturelle	culturale
culturelle	culturali
cultures	culture
curieux	curioso
curiosité	curiosità
cyanure	cianuro
cycle	ciclo
cyclistes	ciclisti
cylindrée	cilindrata
danois	danesi
danoise	danese
débarquer	sbarcare
décembre	dicembre
décennie	decennio
décennies	decenni
décide	deciderà
décident	decide
décider	decidere
décidés	decisi
décisive	decisiva
déclarant	dichiarando
déclaration	dichiarazione
déclarations	dichiarazioni
déclaré	dichiarato
déclarée	dichiarata
déclarées	dichiarate
déclin	declino
décollage	decollo
découvertes	scoperto
découvert	scoperte
décret	decreto
décrets	decreti
décrire	descrive
décrits	descritte
défavorables	sfavorevole
défensive	difensiva
défensives	difensive
déficit	deficit
défini	definita
définie	definita
définies	definiti
définir	definire
définir	definizione
définit	definisce
définitions	definizioni
définitive	definitiva
dégradation	degrado
délicat	delicata
délicat	delicato
délicates	delicati
délimitation	delimitazione
délimiter	delimitare
delta	delta
démissionner	dimissioni
démocratie	democrazia
démocraties	democrazie
démocratique	democratica
démocratique	democratiche
démographie	demografia
démographique	demografica
démographique	demografico
démolies	demolite
démons	demoni
démontrant	dimostrando
démontre	dimostra
démontré	dimostrato
démontrer	dimostrare
dense	densa
densité	densità
département	dipartimento
départements	dipartimenti
dépendance	dipendente
dépendance	dipendenza
dépendant	dipendenza
dépend	dipende
dépendent	dipendenti
déportation	deportazioni
déporté	deportato
déportées	deportati
déportés	deportati
dépression	depressione
député	deputato
dérivé	derivato
désaccord	disaccordo
désastre	disastro
désastreuse	disastrosa
désastreuses	disastrose
descendante	discendente
descendants	discendenti
description	descrizione
descriptions	descrizione
désert	deserti
désordre	disordine
destination	destinazione
destinations	destinazioni
destin	destino
destinée	destinata
destinées	destinati
destins	destini
destructrice	distruttiva
détail	dettagli
détails	dettagli
détention	detenzione
détenu	detenuto
détermination	determinare
détermination	determinazione
détermine	determina
déterminée	determinata
déterminer	determinare
détruire	distrugge
détruits	distrutte
dévastateur	devastante
dévaste	devastando
dévasté	devastato
dévastée	devastata
dévastée	devastazione
devenu	diventata
diabète	diabete
diagnostic	diagnosi
diagnostiqué	diagnosticato
diagramme	diagrammi
dialecte	dialetto
dialectes	dialetti
dialectique	dialettica
dialogue	dialogo
dialogues	dialoghi
diamants	diamanti
diarrhée	diarrea
dictateur	dittatore
dictature	dittatura
dictée	dettato
dictionnaire	dizionario
didactique	didattici
différence	differenza
différences	differenze
différenciées	differenziate
différencier	differenziare
différentes	differenti
difficile	difficile
difficile	difficili
difficulté	difficoltà
difficultés	difficoltà
dignitaires	dignitari
dilemme	dilemma
dimension	dimensione
dimensions	dimensioni
dinosaure	dinosauro
dinosaures	dinosauri
diplomates	diplomatici
diplomatie	diplomazia
diplomatique	diplomatica
diplomatique	diplomatiche
diplomatique	diplomatico
diplôme	diploma
diplôme	diplomi
direct	diretta
directe	diretta
directes	dirette
directeur	direttore
directeurs	direttori
direction	direzione
directions	direzioni
directives	direttive
directrice	direttrice
disciplinaire	disciplinari
discipline	disciplina
disciplines	discipline
discothèque	discoteca
discours	discorsi
discours	discorso
discret	discreta
discrimination	discriminazione
discrimination	discriminazioni
discriminations	discriminazioni
discussions	discussioni
discutable	discutibile
discuté	discusso
discutée	discussa
discutées	discusse
discuter	discutere
disparaît	scompare
dispersion	dispersione
disponibilité	disponibilità
disponible	disponibile
disponibles	disponibili
dispose	dispone
disposé	disposto
disposée	disposta
disposent	dispongono
disposés	disposte
dispositifs	dispositivi
dispositions	disposizioni
dissident	dissidente
distance	distanza
distillation	distillazione
distincte	distinta
distinctes	distinte
distinctifs	distintive
distinction	distinzione
distingue	distingue
distinguent	distinguono
distribué	distribuita
distribuée	distribuita
distribuer	distribuire
distribués	distribuiti
distributeurs	distributori
distribution	distribuzione
district	distretto
divergentes	divergenti
diversification	diversificazione
diversifié	diversificata
diversifiée	diversificata
diversifier	diversificazione
diversion	diversivo
diversité	diversità
divertissement	divertimento
divine	divino
divisé	divisa
divisées	divisa
division	divisione
divisions	divisioni
divorce	divorzio
divorcer	divorziare
doctorants	dottorato
doctorat	dottorato
doctrines	dottrine
documentaire	documentaria
documentaire	documentario
documentation	documentazione
document	documento
documenté	documentata
documentées	documentati
documents	documenti
dogmatique	dogmatica
dogme	dogma
dogmes	dogmi
dollar	dollaro
domestique	domestica
domestique	domestiche
domicile	domicilio
dominante	dominante
dominantes	dominanti
dominantes	predominanti
domination	dominio
domine	domina
dominé	dominata
dominées	dominati
dominer	dominare
donateur	donatore
dorment	dorme
dormir	dormono
dossier	dossier
douce	dolce
douzaine	dozzina
dramatique	drammatica
dramatique	drammatiche
drame	dramma
drames	drammi
drastique	drastica
drastiquement	drasticamente
drogue	droga
drogues	droghe
duré	durato
durée	durata
durer	durare
dynamique	dinamica
dynamique	dinamiche
dynamique	dinamico
dynastique	dinastico
ecclésiastique	ecclesiastica
ecclésiastiques	ecclesiastiche
écoles	scuole
écologie	ecologia
écologique	ecologica
écologique	ecologico
écologiques	ecologici
économie	economia
économique	economica
économique	economiche
économique	economico
économiste	economista
économistes	economisti
écosystème	ecosistema
écosystèmes	ecosistemi
écrire	scrive
écrites	iscritto
écrit	scritte
éditeur	editore
éditoriale	editoriale
éditoriales	editoriali
éducatives	educativi
éducatives	educazione
effective	effettiva
effectué	effettuato
effectuer	effettuare
effectués	effettuate
effet	effetto
effets	effetti
efficace	efficace
efficace	efficiente
efficace	efficienti
efficacement	efficiente
efficacité	efficacia
égyptien	egiziano
égyptiennes	egiziane
égyptiens	egiziani
élaborée	elaborata
élaboré	elaborato
élaborées	elaborati
élaborer	elaborare
électorale	elettorale
électoral	elettorale
électorat	elettorato
électorat	elettori
électricité	elettrica
électricité	elettricità
électrifié	elettrificata
électrique	elettrico
électriques	elettriche
électromagnétiques	elettromagnetiche
électronique	elettronica
électronique	elettronico
élégantes	eleganti
élémentaire	elementare
élémentaires	elementari
élément	elemento
éléments	elementi
éligible	eleggibile
éliminant	eliminando
éliminée	eliminata
élimine	elimina
éliminé	eliminato
éliminer	eliminare
éliminés	eliminati
élite	elite
élite	élite
élites	elite
élites	élite
émancipation	emancipazione
emblématique	emblematico
émigré	emigrato
émigrer	emigrare
éminent	preminente
émises	emesse
émotionnel	emozionale
empirique	empirico
empreinte	impronta
empreinte	impronte
encadré	inquadrato
encourageant	incoraggiare
endémique	endemica
endémiques	endemiche
énergétique	energetiche
énergie	energetico
énergie	energia
énergies	energie
énergique	energica
énigme	enigma
énorme	enorme
énormes	enormi
enregistrée	registrata
enregistrées	registrate
enregistrement	registrazione
enregistrement	registrazioni
enregistrements	registrazione
enregistrements	registrazioni
enthousiasme	entusiasmo
enthousiaste	entusiasta
entité	entità
entités	entità
entraînement	addestramento
entrepris	intrapreso
entrera	entrare
entrer	entrare
enzyme	enzima
enzymes	enzimi
éolien	eolico
éolienne	eolica
épidémie	epidemia
épidémies	epidemie
épisode	episodio
épisodes	episodi
équatoriale	equatoriale
équivalente	equivalente
équivalent	equivalente
équivalentes	equivalenti
erreur	errore
erronées	errate
escale	scalo
esclavage	schiavi
esclavage	schiavitù
esclave	schiavitù
esclaves	schiavi
esclaves	schiavo
espagnole	spagnola
espagnols	spagnolo
espérer	sperare
espionnage	spionaggio
esprit	spirito
essentiel	essenziale
essentielle	essenziale
esthétiques	estetiche
estimations	stimare
estimées	stimate
estimer	stime
estime	stima
estimé	stimato
estonien	estone
est-ouest	est-ovest
établies	stabiliti
établie	stabilita
établir	stabilire
établi	stabilito
établit	stabilisce
ethnique	etnia
ethnique	etnico
ethniques	etniche
étudiante	studentessa
étudiant	studente
étudiées	studiati
étudier	studiare
étudié	studiato
européenne	europea
européenne	europee
européens	europei
évacuées	evacuare
évacuer	evacuare
évaluées	valutato
évaluer	valutate
évalue	valuta
évalué	valutare
événement	evento
événements	avvenimenti
éventuelle	eventuale
évidentes	evidenti
évident	evidente
évite	evita
évolué	evolute
évoluer	evolvere
évolution	evoluzione
exactes	esatte
exagéré	esagerato
examine	esamina
examiné	esaminato
examiner	esaminare
excellence	eccellente
excellence	eccellenza
excellent	eccellenti
excellent	eccellenza
excellentes	eccellente
exceptionnel	eccezionale
exceptionnelle	eccezionale
excès	eccesso
excessif	eccessive
excessive	eccessiva
excluant	escludendo
exclue	esclusa
exclu	escluso
exclure	esclude
exclus	escluse
exclus	esclusi
exclusive	esclusiva
exclusivement	esclusivamente
exclusives	esclusive
excursions	escursioni
exécutif	esecutivi
exécutif	esecutivo
exécutifs	esecutivi
exécutive	esecutiva
exemplaire	esemplare
exemplaires	esemplari
exemples	esempi
exercée	esercitata
exercée	esercitate
exercé	esercitato
exercent	esercita
exercer	esercitare
exercice	esercizio
exercices	esercizi
exilé	esiliato
existante	esistente
existantes	esistenti
existant	esistente
existe	esiste
existence	esistenza
existentielle	esistenziale
exotique	esotica
exotiques	esotiche
expérience	esperienza
expériences	esperienze
expériences	esperimenti
expérimentales	sperimentale
expérimental	sperimentali
expérimental	sperimentare
expérimentation	esperimenti
expérimentations	esperimenti
expérimenter	sperimentale
expérimenter	sperimentare
experts	esperti
explicite	esplicita
explicite	esplicito
explicites	esplicite
explorée	esplorata
exploré	esplorato
explorer	esplorare
explorer	esplorazione
explosé	esplosa
explosent	esplode
explosion	esplosione
explosions	esplosioni
explosive	esplosiva
explosives	esplosive
exponentielle	esponenziale
exportées	esportati
exporté	esportato
expose	espone
expression	espressione
expressions	espressioni
exprimer	esprimere
exprimer	esprimersi
expulsés	espulsi
extérieure	esterne
extérieur	estero
extérieurs	esterni
extermination	sterminio
externe	esterno
extraction	estrazione
extraire	estrarre
extraits	estratte
extraordinaire	straordinaria
extraordinaire	straordinarie
extrême	estrema
extrême	estreme
extrémistes	estremisti
fabrication	fabbricazione
fabriqué	fabbricato
facilitant	facilitando
facilité	facilitato
faciliter	facilitare
facteur	fattore
facteurs	fattori
facture	fattura
faillite	fallimento
falsification	falsificazione
fameuse	famosa
fameuses	famosi
familiale	familiare
familiales	familiare
familial	familiare
famille	famiglia
famille	familiari
familles	famiglie
fanatique	fanatico
fantasme	fantasia
fantastique	fantastico
fantôme	fantasma
fantômes	fantasmi
farce	farsa
fasciné	affascinato
fascisme	fascismo
fasciste	fascista
fascistes	fascisti
fatales	fatali
fatal	fatale
faune	fauna
fausses	falsi
favorable	favorevole
favorables	favorevoli
favorisée	favorita
favorisé	favorito
fédérale	federale
fédérale	federali
fédéral	federale
félins	felini
féminisme	femministe
féministe	femminista
fenêtres	finestre
ferme	ferma
fermeté	fermamente
ferroviaire	ferroviarie
ferroviaire	ferroviario
fertile	fertile
fertiles	fertili
fertilité	fertilità
festival	festival
fiabilité	affidabilità
fibre	fibra
fibres	fibre
fidèle	fedele
fidèles	fedeli
filiale	filiale
filiales	filiali
filmé	filmato
filtrage	filtro
filtre	filtro
filtres	filtri
finale	finale
finales	finali
financée	finanziata
financé	finanziato
financement	finanziamenti
financer	finanziare
finances	finanze
financière	finanziaria
financière	finanziarie
financier	finanziario
finie	finiti
finlandaise	finlandese
finlandais	finlandese
finlandais	finlandesi
fiscale	fiscale
fiscales	fiscali
fiscalité	fiscale
fission	fissione
flexibilité	flessibilità
flexible	flessibile
flore	flora
flottille	flottiglia
fluctuations	fluttuazioni
fluides	fluido
fluviale	fluviale
fluvial	fluviali
folkloriques	folclore
fonctionnaire	funzionario
fonctionnaires	funzionari
fonctionne	funziona
fonctionné	funzionato
fonctionnel	funzionale
fonctionnelle	funzionale
fonctionner	funzionare
fondamentales	fondamentali
fondamental	fondamentale
fondateur	fondatore
fondateurs	fondatore
fondateurs	fondatori
fondation	fondazione
fondement	fondamento
fondements	fondamenta
fonds	fondi
force	forza
forces	forze
forestière	forestale
forestiers	forestale
format	formato
formation	formazione
formats	formati
forme	forma
formé	formato
formel	formale
formelle	formali
forment	formano
former	formare
formes	forma
formes	forme
formulaires	formulazione
formulation	formulazione
formulations	formulazioni
formulée	formulata
formule	formula
formulé	formulata
formules	formula
forteresse	fortezza
forum	forum
forums	forum
fossile	fossile
fossiles	fossili
fournie	fornita
fournies	fornite
fournisseur	fornitore
fourniture	fornitura
fragile	fragile
fragiles	fragili
fragmentaire	frammentato
fragmentation	frammentazione
française	francese
français	francesi
fréquentes	frequenti
frontière	frontiera
frontières	frontiere
fronts	fronti
fruits	frutta
fumer	fumare
funérailles	funerale
fusion	fusione
galerie	galleria
gamme	gamma
garage	garage
garantie	garanzia
garanties	garanzie
garanti	garantito
garantir	garantire
garantis	garantiti
garantit	garantisce
garde	guardia
gardien	guardiana
gardien	guardiano
gardiens	guardiani
géant	gigante
gendarmerie	gendarmeria
générale	generale
générale	generali
général	generale
générer	generare
génétique	genetiche
génitales	genitali
génocide	genocidio
géographie	geografia
géographique	geografiche
géologique	geologica
géologique	geologiche
géométrie	geometria
géométrique	geometriche
géopolitique	geopolitica
géorgien	georgiano
géorgienne	georgiana
géorgiens	georgiani
gestes	gesti
gestion	gestione
ghetto	ghetto
ghettos	ghetti
glaciaire	glaciale
globale	globale
gloire	gloria
glorieuse	gloriosa
gouvernance	governance
gouvernée	governata
gouverné	governato
gouvernementales	governative
gouvernemental	governativa
gouvernementaux	governativi
gouvernement	governo
gouvernements	governi
gouvernent	governano
gouverner	governare
gouverneur	governatore
gouverneurs	governatori
graduelle	graduale
grammes	grammi
graphique	grafica
gratuite	gratuita
gratuitement	gratuito
gratuites	gratuiti
graves	gravi
gravité	gravità
grecques	greche
grotesque	grottesco
groupe	gruppo
groupes	gruppi
habitat	habitat
habitats	habitat
harmonie	armonia
harmonieuse	armonico
hectare	ettaro
hectares	ettari
hégémonie	egemonia
hélicoptère	elicottero
hélicoptères	elicotteri
hémorragie	emorragia
hiérarchie	gerarchia
hiérarchique	gerarchico
histoire	storia
historique	storica
historique	storiche
hockey	hockey
holocauste	olocausto
hommage	omaggio
homogène	omogenea
homogène	omogeneo
homogènes	omogenee
homosexualité	omosessuale
homosexualité	omosessualità
homosexuelles	omosessuali
homosexuel	omosessuali
homosexuels	omosessuali
homosexuels	omosessualità
honoré	onorato
honorer	onorare
horizon	orizzonte
horizons	orizzonti
horizontale	orizzontale
horizontales	orizzontale
horizontal	orizzontale
hormones	ormonale
hormones	ormoni
hostile	ostile
hostile	ostili
hostile	ostilità
hostilité	ostile
humain	umana
humanisme	umanesimo
humaniste	umanista
humaniste	umanistica
humanitaire	umanitari
humanitaire	umanitarie
humanité	umanità
humide	umide
humilié	umiliato
humoristique	umoristico
hybride	ibrida
hydraulique	idraulica
hydroélectrique	idroelettrica
hydrogène	idrogeno
hydrographique	idrografico
icônes	icone
idéales	ideali
idéal	ideale
idéaliste	idealista
identification	identificazione
identifiée	identificata
identifiées	identificati
identifie	identifica
identifié	identificato
identifier	identificare
identique	identica
identiques	identiche
identité	identità
idéologie	ideologia
idéologique	ideologica
idéologique	ideologiche
ignorant	ignorando
ignorée	ignorata
ignore	ignora
ignoré	ignorato
ignorer	ignorare
ignorés	ignorati
illégale	illegale
illégal	illegale
illégitime	illegittima
illégitime	illegittimo
illimité	illimitato
illusoire	illusione
illustre	illustra
illustré	illustrata
illustrer	illustrare
illustres	illustri
image	immagine
images	immagini
imaginaire	immaginaria
imaginaires	immaginari
imagination	immaginazione
imaginé	immaginato
imaginer	immaginare
imiter	imitare
immédiate	immediate
immédiatement	immediato
immédiat	immediata
immigrants	immigranti
immigrants	immigrati
immigrants	migranti
immigration	immigrazione
imminente	imminente
imminent	imminente
immobilière	immobiliare
immobilier	immobiliare
immunitaire	immunitario
immunité	immunità
impact	impatto
imparfait	imperfetto
impératif	imperativo
impériale	imperiale
implications	implicazioni
implicite	implicita
implicitement	implicitamente
implique	implica
impopulaire	impopolare
importance	importante
importance	importanza
importante	importanza
importantes	importanti
importation	importazione
importations	importazioni
importées	importati
importé	importato
imposées	imposte
impose	impone
imposé	imposta
imposé	imposto
impossible	impossibile
impossibles	impossibili
impôt	imposta
impression	impressione
impressionnantes	impressionanti
impressionnant	imponente
impressionnant	impressionante
impressions	impressioni
improvisation	improvvisata
impulsion	impulso
impulsions	impulsi
inaugurale	inaugurale
inauguration	inaugurazione
inauguré	inaugurato
incapable	incapace
incapacité	incapacità
incarcéré	incarcerato
incendie	incendio
incendies	incendi
incertain	incerta
incertain	incerto
incertitude	incertezza
incident	incidente
incidents	incidenti
incluait	includeva
incluent	includono
inclure	includere
incluse	inclusa
incluses	inclusi
inclut	includere
incolore	incolore
incompatibles	incompatibili
incomplète	incompleta
incomplet	incompleta
incorporées	incorporate
incorporer	incorporare
incroyable	incredibile
incroyables	incredibili
incursions	incursioni
indéfiniment	infinito
indépendance	indipendente
indépendance	indipendenza
indépendante	indipendente
indépendant	indipendente
indépendant	indipendenza
indépendants	indipendenti
indéterminée	indeterminato
indicateur	indicatore
indicateurs	indicatori
indicatif	indicativo
indication	indice
indice	indice
indices	indizi
indien	indiana
indien	indiani
indiennes	indiane
indiens	indiani
indifférence	indifferenza
indigène	indigena
indigènes	indigeni
indique	indica
indiquer	indicare
indirecte	indiretta
indirecte	indiretto
indirectes	indirette
indispensable	indispensabile
indispensables	indispensabili
individuel	individuale
individuelles	individuali
individu	individuo
individus	individui
indonésien	indonesiano
industrialisation	industrializzazione
industrie	industria
industrie	industrie
industrielle	industriale
industrielle	industriali
industries	industrie
inefficace	inefficace
inefficace	inefficaci
inévitable	inevitabile
inexistante	inesistente
inexistant	inesistente
infantile	infantile
infectées	infette
infecté	infettato
infectieuses	infettive
infection	infezione
infiltration	infiltrazioni
inflation	inflazione
influencée	influenzata
influencées	influenzati
influence	influente
influence	influenza
influencé	influenzato
influencer	influenzare
influences	influenze
influentes	influenti
influent	influenza
influents	influenti
informateur	informatore
information	informare
information	informazione
informations	informazioni
informatique	informatica
informatique	informatico
informatiques	informatiche
informe	informa
informé	informato
informel	informale
informelle	informali
informer	informare
informés	informati
infrastructure	infrastrutture
infrastructures	infrastrutture
ingénierie	ingegneria
ingénieur	ingegnere
ingrédient	ingrediente
ingrédients	ingredienti
initiale	iniziale
initiales	iniziali
initial	iniziale
initiative	iniziativa
initiative	iniziative
initiatives	iniziative
innovante	innovativa
innovant	innovativo
innovations	innovazioni
inondations	inondazioni
inscrites	inserite
insistance	insistenza
insiste	insiste
inspecteur	ispettore
inspection	ispezione
inspiration	ispirazione
inspirée	ispirata
inspirées	ispirate
inspire	ispira
inspiré	ispirato
inspirer	ispirare
inspirés	ispirati
instabilité	instabilità
instable	instabile
instable	instabili
installation	installare
installé	installata
installer	installare
installés	installati
instance	istanza
instantanée	istantanea
instantané	istante
institution	istituzione
institutionnel	istituzionale
institutionnelle	istituzionale
institutionnelles	istituzionali
institutions	istituzioni
institut	istituto
instituts	istituti
instructeurs	istruttori
instructions	istruzioni
instrumentale	strumentale
instruments	strumenti
insuffisantes	insufficiente
insuffisant	insufficiente
insulaire	insulare
intacte	intatta
intacte	intatto
intactes	intatte
intégrante	integrante
intégration	integrazione
intégrée	integrata
intègre	integra
intégrer	integrare
intégrité	integrità
intellectuelle	intellettuale
intellectuels	intellettuali
intelligence	intelligente
intelligente	intelligente
intelligente	intelligenza
intelligent	intelligente
intense	intensa
intense	intenso
intenses	intensi
intensif	intensiva
intensive	intensiva
intention	intendono
intention	intenzione
intentionnellement	intenzionalmente
intentions	intenzioni
interaction	interazione
interactives	interattiva
interagir	interagire
intercepté	intercettato
intercontinentale	intercontinentale
interdiction	interdizione
interdisciplinaire	interdisciplinare
intéressantes	interessanti
intéressant	interessante
intéressée	interessata
intéressées	interessate
intéresse	interessa
intéressé	interessato
intérêts	interesse
interface	interfaccia
intérim	interim
intermédiaire	intermedia
internationale	internazionale
international	internazionale
interne	interna
interne	interno
internes	interna
interprétation	interpretazione
interprétation	interpretazioni
interprétations	interpretazioni
interprétée	interpretando
interprétées	interpretati
interprète	interpreta
interprété	interpretato
interprète	interprete
interpréter	interpretare
interprètes	interpreti
interrogatoires	interrogatori
interrogé	interrogato
intervalles	intervalli
intervenir	intervenire
intervention	intervento
intervenu	intervenuta
interviennent	intervengono
interview	intervista
interviews	interviste
intimes	intima
intitulées	intitolate
intitulé	intitolata
intrinsèque	intrinseca
intrinsèque	intrinseco
introduction	introdurre
introduction	introduttiva
introduction	introduzione
introduisant	introducendo
introduisent	introducono
introduite	introdotta
introduit	introdotto
introduits	introdotte
inutile	inutile
inutiles	inutili
invasion	invasione
invasions	invasioni
inventaire	inventario
inventée	inventata
inventé	inventato
inventeur	inventore
inventeurs	inventori
invention	invenzioni
inventions	invenzioni
inversée	inversa
inversé	invertita
inversé	invertiti
inverser	invertire
inverse	viceversa
investi	investito
investir	investire
investissement	investimento
investissements	investimenti
investisseurs	investitori
invisible	invisibile
invisibles	invisibile
invitée	invitata
invitées	invitati
invite	invita
invité	invitato
invités	invitati
involontairement	involontariamente
invoquant	invocando
irakiennes	irachene
irakiens	iracheni
iranien	iraniano
iranienne	iraniana
iraniens	iraniani
irlandaise	irlandese
irlandais	irlandese
irlandais	irlandesi
ironie	ironia
ironie	ironico
irréversible	irreversibile
irrigation	irrigazione
irrité	irritato
islamique	islamica
islamique	islamiche
islamique	islamico
islam	islam
islandaise	islandese
islandais	islandese
isotopes	isotopi
israélien	israeliano
israélienne	israeliane
israéliens	israeliani
italien	italiana
italienne	italiane
italienne	italiano
italiens	italiani
japonais	giapponesi
jardin	giardino
journalisme	giornalismo
journaliste	giornalista
journaliste	giornalisti
journalistique	giornalista
journalistique	giornalistiche
judiciaire	giudiziaria
judiciaire	giudiziarie
judiciaire	giudiziario
jungle	giungla
juridique	giuridica
juridique	giuridiche
jurisprudence	giurisprudenza
juristes	giuristi
justification	giustificare
justifie	giustifica
justifie	giustificata
justifier	giustificare
justifier	giustificazione
kilogrammes	chilogrammi
kilomètre	chilometro
kilomètres	chilometri
kurdes	curdi
laboratoire	laboratorio
laboratoires	laboratori
labyrinthe	labirinto
laïcs	laiche
laisse	lascia
laitiers	latte
lancés	lanciati
large	larga
larmes	lacrime
latente	latente
latin	latino
leader	leader
leaders	leader
lecture	lettura
légale	legale
légalité	legalità
légal	legale
légendaire	leggendaria
législatif	legislativo
législation	legislazione
législative	legislativa
législature	legislatura
légitime	legittima
légitime	legittimo
légitimes	legittimi
légitimité	legittimità
lentes	lenti
lesbiennes	lesbiche
letton	lettone
lettons	lettoni
libérale	liberale
libérale	liberali
libéralisation	liberalizzazione
libéralisme	liberalismo
libéral	liberale
libère	liberando
libère	liberare
libérer	liberare
liberté	libertà
libre	libera
libre	libero
libyen	libico
licence	licenza
licence	licenze
ligne	linea
lignes	linee
limitation	limitazione
limitations	limitazioni
limitée	limitata
limite	limita
limite	limite
limiter	limitare
limites	limiti
linéaire	lineare
linguistique	linguistica
linguistique	linguistiche
linguistique	linguistico
liste	lista
listes	liste
litre	litro
littéraire	letteraria
littéraire	letterarie
littéralement	letteralmente
littéral	letteralmente
littérature	letteratura
lituanien	lituano
lituanienne	lituana
lituaniens	lituani
locale	locale
localement	locale
locales	locali
localisé	localizzato
localiser	localizzare
locomotive	locomotiva
locomotives	locomotive
logique	logica
logiques	logiche
logistique	logistica
logistiques	logistiche
londonien	londinese
longévité	longevità
longs	lunghi
lucide	lucida
lucidité	lucidità
lumineuse	luminosa
lutte	lotta
lutté	lottato
macédonien	macedone
macédonienne	macedone
mafia	mafie
mafieux	mafiosi
magique	magica
magiques	magiche
majoritaire	maggioritaria
majoritaires	maggioritaria
malaria	malaria
maltais	maltese
mammifère	mammifero
mammifères	mammiferi
mandat	mandato
mandats	mandati
manifestation	manifestazione
manifeste	manifesta
manifesté	manifestato
manipulation	manipolare
manipulation	manipolazione
manipuler	manipolare
manœuvre	manovra
manœuvrer	manovre
manœuvres	manovre
manuelles	manuali
manuel	manuale
manuscrit	manoscritto
marathon	maratona
marbre	marmo
marginales	marginali
marginal	marginale
marine	marina
marines	marina
maritime	marittima
maritime	marittimi
maritimes	marittime
marketing	marketing
marocain	marocchino
marquage	marcatura
marquage	marchio
martyr	martire
marxisme	marxismo
marxiste	marxista
masculine	maschi
massacre	massacro
massacrés	massacrati
massacres	massacri
masse	massa
masses	masse
massif	massicci
massive	massicce
matérielle	materiale
matérielles	materiali
matériel	materiale
maternelle	materna
maternel	materno
maternité	maternità
mathématique	matematica
mathématique	matematico
mathématiques	matematici
matière	materia
matrimoniale	matrimoniale
mature	matura
mature	maturo
matures	matura
maturité	maturità
maximales	massime
maximal	massima
maximal	massimo
mécanique	meccanicamente
mécanique	meccaniche
mécanisme	meccanismo
mécanismes	meccanismi
médaille	medaglia
médecine	medicina
médiateur	mediatore
médiatique	mediatica
médiatique	mediatico
médical	medico
médicament	medicina
médicaments	medicinali
médiévale	medioevali
médiéval	medievale
médiocre	mediocre
méditerranéen	mediterranea
méditerranéen	mediterraneo
méditerranéenne	mediterranea
mélancolie	malinconia
membre	membro
membres	membri
mémoire	memoria
mémorandum	memorandum
mentale	mentale
mentalement	mentalmente
mentalité	mentalità
mental	mentale
mentionnée	menzionata
mentionné	menzionato
mercenaire	mercenarie
mercenaires	mercenari
mercure	mercurio
mérite	merita
mérites	meriti
messagers	messaggero
mesurées	misurate
mesure	misura
mesuré	misurato
mesurer	misurare
mesures	misure
métabolisme	metaboliche
métalliques	metallica
métallurgie	metallurgia
métal	metallo
météorologique	meteorologica
météorologique	meteorologico
météorologiques	meteorologiche
méthane	metano
méthode	metodo
méthodes	metodi
méthodologie	metodologia
méthodologique	metodologico
mètre	metro
métriques	metriche
métro	metropolitana
mexicaine	messicana
mexicaines	messicane
mexicain	messicano
micro-ondes	microonde
micro-organismes	microrganismi
microphone	microfono
migration	migrazione
migratoire	migratori
migratoire	migrazione
migratoires	migratori
milices	milizia
milices	milizie
militaire	militare
militaire	militari
militante	militante
milliard	miliardo
milliards	miliardi
million	milione
millions	milioni
minerai	minerale
minerai	minerali
minérale	minerale
minérales	minerali
minéral	minerale
mineures	minori
mineur	minorenne
mineurs	minorenni
miniature	miniatura
minière	mineraria
miniers	minerarie
minimales	minima
minimal	minima
minimal	minimo
ministères	ministeri
ministérielle	ministeriale
ministérielle	ministeriali
ministériel	ministeriale
ministre	ministro
ministres	ministri
minoritaire	minoritaria
minorité	minoranza
minuscules	minuscole
minute	minuto
minutes	minuti
miracle	miracoli
miracle	miracolo
miracle	miracolosa
misère	miseria
mission	missione
mission	missioni
missionnaire	missionario
missionnaires	missionari
mixte	mista
mixtes	miste
mobile	mobile
mobiles	mobili
mobilisation	mobilitazione
mobiliser	mobilitazione
mobilité	mobilità
modèles	modelli
modérateur	moderatore
modérée	moderata
modéré	moderato
moderne	moderna
moderne	moderno
modernes	moderna
modernisation	modernizzazione
moderniser	modernizzare
moderniser	modernizzazione
modernité	modernità
modeste	modesta
modeste	modesto
modestes	modesti
modifiant	modifica
modification	modifiche
modifications	modifiche
modifiée	modificata
modifiées	modificati
modifié	modificata
modifier	modificare
modules	moduli
molécule	molecola
moment	momento
moments	momenti
monarchie	monarchia
monarque	monarca
mondiale	mondiale
mondiales	mondiali
monétaire	monetari
monétaire	monetaria
monétaire	monetario
monnaie	moneta
monnaie	monete
monologues	monologo
monopole	monopolio
monoxyde	monossido
monstre	mostro
montagne	montane
montés	montanti
monuments	monumenti
moralement	morale
morales	morali
moralité	moralità
moral	morale
mortalité	mortalità
mortel	mortale
morte	morta
mortier	mortai
morts	morti
moteur	motore
motivé	motivata
motivé	motivato
motricité	motorie
multimédia	multimediale
multinationale	multinazionale
multiple	multipla
multiples	multipla
multiplicateur	moltiplicatore
multitude	moltitudine
municipales	municipali
muscle	muscolare
musée	museo
musicale	musicale
musicales	musicale
musicien	musicista
musiciens	musicisti
musulmanes	musulmana
musulman	musulmana
musulmans	musulmani
mystérieuses	misteriose
napoléoniennes	napoleoniche
natale	natale
natalité	natalità
nationale	nazionale
nationales	nazionali
nationalisation	nazionalizzazione
nationalisme	nazionalismo
nationaliste	nazionalista
nationaliste	nazionaliste
nationalité	nazionalità
national	nazionale
nation	nazione
naturelles	naturali
naturel	naturale
nature	natura
navale	navale
navales	navali
naviguer	navigare
nazie	nazista
nazisme	nazismo
nazis	nazisti
nébuleuse	nebulosa
nécessaire	necessaria
nécessaire	necessario
nécessaires	necessarie
nécessité	necessità
négative	negativa
négative	negative
négatives	negativi
négocié	negoziato
négocier	negoziare
nerveux	nervoso
nette	netta
neurologiques	neurologici
neutralité	neutralità
neutre	neutrale
neutres	neutri
nickel	nickel
nigérian	nigeriano
niveau	livello
niveaux	livelli
noble	nobile
nobles	nobili
nomade	nomade
nomades	nomadi
nord-américaine	nordamericani
nord-américain	nordamericani
nord-est	nord-est
nordiques	nordici
nord-ouest	nord-ovest
normalement	normale
normales	normali
normal	normale
normand	normanni
norvégien	norvegese
notre	nostra
notre	nostre
notre	nostro
novembre	novembre
nucléaire	nucleare
nucléaire	nucleari
numéros	numeri
nutriments	nutrienti
objectif	obiettivo
objectifs	obiettivi
obligation	obbligo
obligations	obbligazioni
obligations	obblighi
obligatoire	obbligatori
obligatoire	obbligatoria
obligeant	obbligando
obligée	obbligata
oblige	obbliga
obligé	obbligato
obliger	obbligare
obligés	obbligati
obscure	oscura
obscure	oscuro
observateurs	osservatore
observateurs	osservatori
observations	osservazioni
observatoire	osservato
observe	osserva
observé	osservatori
obsession	ossessione
obstacle	ostacolo
obstacles	ostacoli
occasionnelles	occasionale
occidentales	occidentali
occidental	occidentale
occupants	occupanti
occupées	occupate
occupe	occupa
occupé	occupata
océaniques	oceaniche
océan	oceano
océans	oceani
octobre	ottobre
offensive	offensiva
offensive	offensive
offerte	offerta
officielles	ufficiali
officielle	ufficiale
officiel	ufficiale
offrait	offriva
offre	offre
offres	offerte
ombre	ombra
ombres	ombre
opérateur	operatore
opérationnelles	operative
opérationnel	operativo
opinion	opinione
opinions	opinioni
opportunité	opportunità
opportunités	opportunità
opposées	opposte
opté	optato
optimale	ottimale
optimal	ottimale
optimiser	ottimizzare
optimiste	ottimismo
optimiste	ottimista
option	opzione
oracle	oracolo
orale	orale
orales	orali
orchestre	orchestra
ordinaire	ordinaria
ordinaire	ordinarie
ordonnée	ordinato
ordonnées	ordinata
ordonné	ordinata
oreilles	orecchie
organe	organo
organes	organi
organique	organica
organique	organico
organiques	organici
organisateurs	organizzatori
organisationnelle	organizzativa
organisation	organizzazione
organisation	organizzazioni
organisations	organizzazioni
organisée	organizzate
organise	organizza
organisé	organizzata
organisé	organizzato
organiser	organizzare
organisme	organismo
orientation	orientamento
orientations	orientamenti
orientée	orientata
orienté	orientato
originale	originale
originales	originali
originalité	originalità
original	originale
origine	origine
origines	origini
ornementales	ornamentali
orthodoxe	ortodosse
orthodoxe	ortodosso
orthodoxes	ortodossi
ottomane	ottomana
ottoman	ottomani
ouragan	uragano
palestinienne	palestinese
palestinien	palestinese
palestiniens	palestinesi
palme	palma
panique	panico
panneau	pannello
pantalons	pantaloni
papale	papale
paquet	pacchetto
parabole	parabola
parade	parata
paradigme	paradigma
paradoxalement	paradossale
paradoxe	paradosso
parallèle	parallela
parallèle	parallelo
parallèles	parallele
paralysie	paralisi
paramètre	parametro
paramètres	parametri
paramilitaire	paramilitare
paramilitaires	paramilitari
parcourue	percorsa
parcs	parchi
parfums	profumi
parlementaire	parlamentare
parlementaire	parlamentari
parlement	parlamento
parlements	parlamenti
partenaire	partner
partenaires	partner
participaient	partecipavano
participant	partecipanti
participants	partecipanti
participation	partecipazione
participe	partecipa
participé	partecipato
participer	partecipare
particules	particelle
partielles	parziali
parti	partito
partis	partiti
passager	passeggero
passagers	passeggeri
passion	passione
passive	passiva
passive	passivo
pâtes	pasta
pathogène	patogeno
pathogènes	patogeni
patient	paziente
patriarcale	patriarcale
patriarche	patriarca
patriarches	patriarchi
patrimoine	patrimonio
patriote	patriota
patriotique	patriottici
patriotique	patriottico
patriotisme	patriottismo
patrouille	pattugliamento
pause	pausa
pauses	pause
pavillon	padiglione
pédagogue	pedagogista
pèlerinage	pellegrinaggio
pénale	penali
pénal	penale
péninsule	penisola
pénitentiaire	penitenziario
pension	pensione
pension	pensioni
pensions	pensioni
perception	percezione
perçu	percepito
perdent	perdono
perdre	perde
perdues	perdute
performance	performance
péril	pericolo
périmètre	perimetro
période	periodi
période	periodo
périodes	periodi
périodique	periodica
périodiques	periodiche
périphérie	periferia
permanente	permanente
permanentes	permanenti
permet	permettere
permettent	permettono
persane	persiana
persécuté	perseguitato
persécutés	perseguitati
persécution	persecuzione
perse	persiana
persistantes	persistenti
persistant	persistente
persiste	persiste
personnages	personaggi
personnalité	personalità
personnelles	personali
personne	persona
personnes	persone
perspective	prospettiva
perspectives	prospettive
perte	perdita
peste	peste
pétrole	petrolio
pétrolière	petrolifera
pétrolière	petrolifere
pétrolier	petroliera
pharmaceutique	farmaceutica
pharmaceutique	farmaceutiche
pharmacien	farmacista
pharmacies	farmacia
philosophique	filosofica
photographié	fotografare
photographie	fotografia
photographies	fotografia
pianiste	pianista
pierres	pietre
piétons	pedoni
pilote	pilota
pionniers	pionieri
piste	pista
pittoresque	pittoresca
planète	pianeta
planification	pianificare
planification	pianificazione
planifiée	pianificata
plans	piani
planter	piantare
plantes	piante
plasma	plasma
plastique	plastica
plastiques	plastiche
plateforme	piattaforma
plateforme	piattaforme
plateformes	piattaforme
platine	platino
plausible	plausibile
plébiscite	plebiscito
poésie	poesia
point	punto
polaire	polare
polarisation	polarizzazione
police	polizia
politiciens	politici
politique	politica
politique	politico
politiques	politiche
pollen	polline
pompiers	pompieri
populaire	popolare
populaires	popolari
popularité	popolarità
population	popolazione
populations	popolazioni
pornographiques	pornografici
portables	portatili
portail	portale
portails	portali
porte-avions	portaerei
portefeuille	portafoglio
ports	porti
portuaire	portuale
portugaise	portoghese
portugais	portoghese
portugais	portoghesi
positive	positiva
positive	positivo
positives	positive
possession	possesso
possibilité	possibilità
possible	possibile
possibles	possibili
potable	potabile
potentielles	potenziali
potentiel	potenziale
poumon	polmoni
pourcentage	percentuale
pourcentages	percentuali
pragmatique	pragmatica
pratiquées	praticati
pratique	pratica
pratique	pratico
pratiques	pratiche
précaire	precaria
précaire	precarie
précaution	precauzione
précise	precisa
précis	precisa
précurseur	precursore
précurseurs	precursori
prédominante	predominante
préférentiel	preferenziale
préfet	prefetto
préliminaire	preliminare
préliminaires	preliminari
prélude	preludio
prématuré	prematura
prémisses	premesse
préoccupation	preoccupazione
préoccupations	preoccupazioni
préoccupe	preoccupa
préoccupé	preoccupato
préparations	preparati
présentées	presentate
présente	presenta
présentera	presentare
présenter	presentare
présentes	presenti
présidentielle	presidenziali
présidentiel	presidenziale
pression	pressione
pression	pressioni
prestige	prestigio
prestigieuse	prestigiosa
prestigieuse	prestigioso
prestigieuses	prestigiose
prétendants	pretendenti
prétexte	pretesto
prévenir	prevenire
prévenir	prevenzione
prévention	prevenzione
préventive	preventiva
préventive	preventivo
prévisions	previsioni
prévu	previsto
primaire	primaria
primaire	primarie
primates	primati
primitive	primitivo
principalement	principale
principale	principale
principales	principali
principal	principale
principauté	principato
principautés	principati
principe	principio
priorité	priorità
priorités	priorità
prisonnier	prigioniero
prisonniers	prigionieri
privatisation	privatizzazione
privée	privata
privé	privato
privés	privati
privilège	privilegio
privilèges	privilegi
privilégiée	privilegiata
privilégiées	privilegiati
privilégié	privilegiato
probabilité	probabilità
probablement	probabilmente
probables	probabili
problématique	problematica
problème	problema
problèmes	problemi
procédure	procedura
procédures	procedure
procès	processi
processus	processo
proclamation	proclamazione
proclamée	proclamata
proclamé	proclamato
proclamer	proclamare
procureur	procuratore
procureurs	procuratori
producteur	produttore
producteurs	produttori
producteurs	produttrici
production	produzione
productive	produttiva
productives	produttive
productivité	produttività
produire	produrre
produisaient	produceva
produisent	producono
professeur	professor
professeurs	professori
professionnalisme	professionalità
professionnalisme	professionista
professionnelle	professionale
professionnel	professionale
professionnels	professionisti
profession	professione
professions	professioni
profils	profili
profitant	approfitta
profitent	approfittando
profiter	profitto
profits	profitti
profonde	profonda
profonde	profonde
profond	profonda
programmation	programmazione
programme	programma
programmes	programmi
progrès	progressi
progrès	progresso
progressif	progressivo
progressistes	progressiste
progressive	progressiva
projet	progetto
projets	progetti
prolifération	proliferazione
prolongée	prolungati
promet	promette
promises	promessi
promoteur	promotore
promoteurs	promotori
promotionnels	promozionali
promouvant	promuovendo
promouvoir	promuovere
promu	promosso
propagande	propaganda
proportionnelle	proporzionale
proportionnel	proporzione
proportions	proporzioni
proposées	proposte
proposent	propongono
propose	propone
propres	proprie
propriétaire	proprietario
propriétaires	proprietari
propriété	proprietà
propulsion	propulsione
prospère	prospera
prospère	prosperare
prospère	prospero
prospérité	prosperità
prostituée	prostituta
prostitution	prostituzione
protecteur	protettivo
protecteurs	protettori
protection	protezione
protectrice	protettiva
protéger	proteggere
protéines	proteico
protestante	protestante
protestantes	protestanti
proteste	protesta
protester	protesta
protester	protestare
protocole	protocollo
protocoles	protocolli
prototype	prototipo
provenaient	proveniva
provenir	provenga
proviennent	provengono
provient	proviene
province	provincia
provinces	province
provinciales	provinciali
provisoire	provvisoria
provisoires	provvisori
provocateur	provocatorio
provoquant	provocando
provoque	provoca
provoqué	provocato
prudemment	prudente
prudence	prudenza
psychiatre	psichiatra
psychiatriques	psichiatrici
psychologie	psicologia
psychologique	psicologica
psychologique	psicologiche
publiant	pubblicando
publications	pubblicazioni
publicitaire	pubblicitari
publicitaires	pubblicità
publicitaires	pubblicitarie
publicité	pubblicità
public	pubblica
public	pubblico
publics	pubbliche
publiée	pubblicata
publiées	pubblicate
publié	pubblicata
publiera	pubblicare
pyramide	piramide
qualification	qualifica
qualifiée	qualificate
qualitatif	qualitativo
qualitative	qualitativa
quantitative	quantitativa
quantitative	quantitativi
quarantaine	quarantena
quartier	quartier
quartiers	quartieri
rabbin	rabbino
raciale	razziale
raciales	razziale
racisme	razzismo
raciste	razzista
radar	radar
radiation	radiazioni
radiations	radiazioni
radicale	radicale
radicales	radicali
radical	radicale
radioactif	radioattivo
radioactifs	radioattive
radioactivité	radioattività
raffinerie	raffineria
raffineries	raffinerie
ramifications	ramificazioni
rampes	rampa
rapatriement	rimpatrio
rapide	rapida
rapides	rapida
rapportés	riportati
rapporteur	relatore
ratification	ratifica
ratifiée	ratificata
ratifié	ratificato
rationnelle	razionale
rationnelles	razionali
réacteur	reattore
réactif	reattiva
réactive	reattiva
réaliste	realistica
réalistes	realistiche
réalité	realtà
rebelle	ribelle
rebelles	ribelli
rébellion	ribellione
recensement	censimento
recensements	censimenti
récente	recenti
récent	recente
réciproques	reciproche
récolte	raccolti
récolte	raccolto
recommandation	raccomanda
recommandation	raccomandazione
recommandations	raccomandazioni
recommandée	raccomandata
recommandées	raccomandati
recommandé	raccomandato
recommande	raccomandazione
récompense	ricompensa
récompensé	ricompensato
récompenser	ricompensare
récompenses	ricompense
réconciliation	riconciliazione
reconnues	riconosciute
reconstituée	ricostituita
reconstitué	ricostituito
reconstitue	ricostruisce
reconstruction	ricostruzione
reconstruire	ricostruire
reconstruites	ricostruite
record	record
recours	ricorsi
recouvrer	recuperare
recrutement	reclutamento
recruté	reclutato
recruter	reclutare
récurrentes	ricorrenti
récurrent	ricorrente
recyclage	riciclaggio
réduire	ridurre
réécrire	riscrivere
réel	reale
référendum	referendum
reflétant	riflettendo
reflète	riflette
refléter	riflettere
refonte	riformata
réformateur	riformista
réformée	riformati
réforme	riforma
réformé	riformato
réforme	riforme
réformer	riformare
réformes	riforme
réformiste	riformista
refuge	rifugio
réfugié	rifugiato
refusé	rifiutati
régiments	reggimenti
régime	regime
régionale	regionali
régional	regionale
région	regione
registre	registro
registres	registri
réglementaire	regolamentazione
réglementation	regolamentare
réglementations	regolamenti
réglementé	regolamentata
réglementer	regolamentare
règlement	regolamento
règlements	regolamenti
régulier	regolari
réintroduit	reintrodotto
relance	rilanciare
relations	relazioni
relativement	relativamente
religieuse	religiose
religieux	religioso
religion	religione
religion	religiosa
religions	religioni
renouvelable	energie
réorganisation	riorganizzazione
réorganisée	riorganizzata
réorganiser	riorganizzare
réorganiser	riorganizzazione
réparations	riparazioni
réparer	riparare
répercussions	ripercussioni
répondre	risponde
représailles	rappresaglie
représentaient	rappresentavano
représentant	rappresentante
représentants	rappresentanti
représentatif	rappresentativo
représentation	rappresentanza
représentation	rappresentare
représentative	rappresentativa
représentative	rappresentative
représentée	rappresentata
représentées	rappresentate
représenté	rappresentato
représenter	rappresentanza
représenter	rappresentare
répression	repressione
réprimer	reprimere
reproduction	riproduzione
républicaines	repubblicane
républicain	repubblicano
république	repubblica
républiques	repubbliche
réputation	reputazione
réserve	riserve
résident	residente
résistante	resistenti
résistantes	resistenti
résistant	resistente
résister	resistere
respectant	rispettando
respectée	rispettata
respectées	rispettate
respecte	rispetta
respecté	rispettato
respecter	rispettare
respectifs	rispettive
respiratoire	respiratori
responsabilité	responsabilità
responsable	responsabile
responsables	responsabili
ressources	risorse
restaurants	ristoranti
reste	resto
restitution	restituzione
restriction	restrizioni
restrictions	restrizioni
restructuration	ristrutturazione
résultat	risultato
résultats	risultati
rétablie	ristabilita
rétabli	ristabilito
rétablir	ristabilire
retirer	ritirare
retirés	ritirate
rétrospective	retrospettiva
réunification	riunificazione
réunion	riunione
réuni	riuniti
réuni	riunito
réunir	riunire
réunis	riuniti
revendiqué	rivendicato
revers	regressione
révolte	rivolta
révoltes	rivolte
révolutionnaire	rivoluzionario
révolutionnaires	rivoluzionarie
révolution	rivoluzione
révolutions	rivoluzioni
rigide	rigida
rigide	rigido
rigides	rigidità
rigoureuse	rigorosa
risque	rischio
rituel	rituale
rituels	rituali
rivales	rivali
rivalité	rivalità
rival	rivale
rivaux	rivali
robuste	robusta
robuste	robusto
roche	roccia
romain	romana
romain	romano
roman	romanzo
romantique	romantica
romantique	romantiche
romantique	romanticismo
ronde	rotonda
rondes	rotonde
rotation	rotazione
roumaines	rumene
roumain	romena
roumain	romeno
routine	routine
rubrique	rubrica
rudimentaire	rudimentale
ruiné	rovinato
ruines	rovine
rurales	rurali
rural	rurale
russe	russa
russe	russo
russes	russe
sabotage	sabotaggio
sacrée	sacra
sacrées	sacri
sacré	sacro
sacrifier	sacrificare
sacrifie	sacrifica
sacrifié	sacrificato
salaire	salari
salaire	salario
salaires	salari
sanctions	sanzioni
sanitaires	sanitarie
satellite	satellite
satiriques	satirici
satisfaire	soddisfare
sauver	salvare
sauve	salva
scandale	scandalo
scandales	scandali
scandinaves	scandinavi
scénario	scenario
scénarios	scenari
scènes	scene
scepticisme	scetticismo
sceptique	scettico
sceptiques	scettici
schisme	scisma
schizophrénie	schizofrenia
scrupules	scrupoli
sculpture	scultura
sécession	secessione
secondaire	secondaria
secondaire	secondarie
secondes	secondi
secrétaire	segretario
secrétariat	segretariato
secrète	segreta
secret	segreto
secrets	segrete
secte	setta
secteur	settore
secteurs	settori
section	sezione
sections	sezioni
sécurité	sicurezza
segment	segmento
segments	segmenti
sélective	selettiva
sémantique	semantica
sémantique	semantico
semi-conducteurs	semiconduttori
séminaire	seminario
séminaires	seminari
sénateur	senatore
sénat	senato
sensibilité	sensibilità
sensible	sensibile
sensibles	sensibili
sentimentales	sentimentale
sentiment	sentimento
sentiments	sentimenti
séparatiste	separatista
séparées	separati
séparer	separare
séparer	separarsi
sépare	separa
séparé	separata
septembre	settembre
serbe	serba
serbe	serbe
serbe	serbo
serre	serra
serveur	server
serveurs	server
service	servizio
services	servizi
servir	servire
servi	servito
serviteur	servo
session	sessione
session	sessioni
sexualité	sessualità
sexuelle	sessuale
sexuel	sessuale
sicilienne	siciliana
sicilienne	siciliano
siècles	secoli
signal	segnale
signataires	firmatari
significative	significativa
significatives	significative
similaire	simile
similaires	simili
simplicité	semplicità
simplifiée	semplificata
simplifier	semplificare
simplifié	semplificato
simule	simula
simultanée	simultanea
simultanément	simultaneamente
sincère	sincera
sincérité	sincerità
sirènes	sirene
sismique	sismica
sismique	sismico
situation	situazione
situations	situazioni
située	situata
situées	situati
situé	situato
slogan	slogan
slovaque	slovacca
slovaque	slovacco
slovaques	slovacchi
slovène	slovena
slovène	sloveno
sobre	sobria
s'occuper	occupare
social-démocrate	socialdemocratico
sociale	sociale
sociales	sociali
socialisation	socializzazione
socialisme	socialismo
socialiste	socialista
socialistes	socialisti
sociaux-démocrates	socialdemocratici
société	società
sociologue	sociologo
sodium	sodio
solaire	solare
solaire	solari
soldat	soldato
soldats	soldati
solennelles	solenni
solennel	solenne
solidarité	solidarietà
solide	solida
solide	solido
solides	solida
solution	soluzione
solutions	soluzioni
sondage	sondaggio
sondages	sondaggi
sophistiquée	sofisticati
souffert	sofferto
sourde	sorda
sous-marins	sottomarini
sous-secrétaire	sottosegretario
souterraine	sotterranee
souveraine	sovrana
souveraine	sovrani
souveraineté	sovranità
souverain	sovrano
soviétique	sovietica
soviétique	sovietiche
soviétique	sovietico
spatiale	spaziale
spatiales	spaziali
spéciale	speciale
spéciale	speciali
spécialisation	specializzazione
spécialisée	specializzate
spécialisées	specializzate
spécialisé	specializzata
spécialisé	specializzato
spécialiste	specialista
spécialistes	specialisti
spécifié	specificato
spécifique	specifica
spécifiques	specifiche
spectacle	spettacolo
spectacles	spettacoli
spectaculaire	spettacolare
spectaculaires	spettacolare
spectateur	spettatore
spectateurs	spettatori
spectre	spettro
spéculation	speculazione
spéculative	speculativa
spirale	spirale
spiritualité	spiritualità
spirituelle	spirituali
spirituel	spirituale
splendide	splendido
sponsors	sponsor
spontanées	spontanee
spontané	spontanea
spontané	spontaneo
sporadique	sporadicamente
sporadiques	sporadiche
sportifs	sportivi
sportive	sportiva
sportives	sportiva
sport	sport
squelette	scheletro
stabilisation	stabilizzazione
stabiliser	stabilizzare
stabilisé	stabilizzato
stabilité	stabilità
stable	stabile
stable	stabili
stagnation	ristagno
stalinisme	stalinismo
standardisée	standardizzato
statiques	statiche
statique	statica
statistique	statistica
statistique	statistico
statues	sante
statue	statua
statut	statuto
stimuler	stimolare
stimule	stimola
stimulus	stimolo
stratégies	strategie
stratégie	strategia
stratégique	strategica
stratégique	strategiche
stratégique	strategico
stress	stress
stricte	stretto
structurée	strutturata
structurelles	strutturali
structurel	strutturale
structurer	strutturazione
structures	strutture
structure	struttura
structuré	strutturato
stupide	stupida
stylistique	stilistica
subjectif	soggettive
subordination	subordinazione
subordonnées	subordinate
subordonnée	subordinata
subordonné	subordinato
subordonné	subordinazione
subsistance	sussistenza
substances	sostanze
substantielle	sostanziale
subventions	sovvenzioni
succédé	succeduto
successeurs	successori
successeur	successore
succession	successione
successives	successive
succès	successo
sud-coréen	sudcoreano
sud-est	sud-est
sud-ouest	sud-ovest
suffisamment	sufficiente
suffisantes	sufficiente
suggérer	suggerire
suggère	suggerisce
suggestions	suggerimenti
suggestion	suggerimento
suicide	suicidio
superficielles	superficiali
supérieur	superiore
supériorité	superiorità
supermarché	supermercato
suppléant	supplente
supplémentaires	supplementari
supplémentaire	supplementare
supplément	supplemento
supporter	sopportare
suprématie	supremazia
suprême	suprema
suprême	supremo
surplus	surplus
surprendre	sorprendere
surprend	sorprende
surprise	sorpresa
surprises	sorprese
surpris	sorpresa
surréaliste	surreale
survie	sopravvivenza
survivre	sopravvivere
suspecté	sospettata
suspectés	sospettati
suspectes	sospette
suspendre	sospendere
symboles	simboli
symbolique	simbolica
symbolique	simboliche
symbolise	simboleggia
symbolisme	simbolismo
symétrie	simmetria
symétriques	simmetrico
sympathie	simpatia
symphonie	sinfonia
symptôme	sintomo
synagogue	sinagoga
syndicales	sindacale
syndical	sindacale
syndicat	sindacato
syndicats	sindacali
syndicats	sindacati
syndrome	sindrome
synonyme	sinonimo
syrien	siriano
syriens	siriani
systématique	sistematica
systématique	sistematiche
système	sistema
tableaux	tabelle
tacite	tacito
tactiques	tattica
tactiques	tattiche
tactique	tattica
tactique	tattico
talents	talenti
talent	talenti
tampons	tampone
tarifs	tariffe
tchécoslovaque	cecoslovacco
techniques	tecniche
technique	tecnica
technologies	tecnologie
technologie	tecnologia
technologique	tecnologica
technologique	tecnologiche
technologique	tecnologici
télécommunication	telecomunicazioni
télégramme	telegramma
téléphonie	telefonia
télescope	telescopio
téléspectateurs	telespettatori
températures	temperature
température	temperatura
tempéré	temperata
temples	templi
temple	tempio
temporaire	temporanea
tendances	tendenze
tendance	tendenza
tennis	tennista
tensions	tensioni
tension	tensione
termes	termini
terme	termine
terminaux	terminal
terrain	terreno
terrestre	terrestre
terrestre	terrestri
terreur	terrore
terribles	terribili
terrible	terribile
territoires	territori
territoire	territorio
territoriale	territoriale
terrorisme	terrorismo
terroristes	terroristi
terroriste	terrorista
testament	testamento
testées	testati
testée	testata
tester	testare
textes	testi
textiles	tessile
textile	tessile
thématiques	tematica
théologie	teologia
théories	teorie
théorie	teoria
thérapeutiques	terapeutiche
thérapeutique	terapeutica
thérapies	terapie
thérapie	terapia
thermales	termali
thermique	termica
tibétain	tibetana
tibétain	tibetano
tiers	terzi
tigres	tigri
tigre	tigre
timide	timida
timide	timido
titres	titoli
titulaire	titolare
tolérance	tolleranza
tolérer	tollerare
toléré	tollerato
topographique	topografia
torturés	torturati
torture	tortura
torturé	torturato
torture	torture
totalement	totale
totales	totali
totalitarisme	totalitarismo
total	totale
total	totali
tourisme	turismo
touristes	turisti
touriste	turista
touristiques	turistiche
touristique	turistica
touristique	turistici
toutes	tutte
toxicité	tossicità
toxines	tossine
toxiques	tossiche
toxique	tossica
tracteurs	trattori
tracteur	trattore
traditionnelles	tradizionali
traditionnelle	tradizionale
traditionnel	tradizionale
traditions	tradizioni
tradition	tradizione
traducteurs	traduttori
traductions	traduzioni
traduction	traduzione
traduction	traduzioni
traduits	tradotte
trafic	traffico
tragédie	tragedia
tragiques	tragiche
tragique	tragica
tragique	tragico
traitées	trattate
traitements	trattamenti
traitement	trattamento
traite	trattano
traité	trattato
transaction	transazione
transatlantique	transatlantico
transcription	trascrizione
transférées	trasferite
transférée	trasferita
transférer	trasferendo
transférer	trasferire
transférer	trasferisce
transfère	trasferire
transféré	trasferito
transferts	trasferimenti
transfert	trasferimento
transformant	trasformando
transformations	trasformazioni
transformation	trasformazione
transformée	trasformata
transformer	trasformare
transformés	trasformate
transforme	trasforma
transformé	trasformata
transition	transizione
transit	transito
transmises	trasmesse
transmise	trasmessa
transmission	trasmissione
transparence	trasparente
transparence	trasparenza
transparentes	trasparente
transparente	trasparente
transparente	trasparenza
transplantation	trapianti
transportées	trasportate
transportée	trasportata
transporter	trasportare
transporte	trasporta
transporté	trasportato
transports	trasporti
transport	trasporti
transposée	trasposta
transposé	trasposto
transversales	trasversali
transversal	trasversale
traumatismes	traumi
traverse	attraversa
traverser	attraversare
tremplin	trampolino
trésorier	tesoriere
triangle	triangolo
tribales	tribali
tribale	tribale
tribunaux	tribunali
tribune	tribuna
tribus	tribù
trimestre	trimestre
tripartite	tripartito
triple	triplice
tristes	tristi
triste	triste
tropicales	tropicali
tropicale	tropicale
tropicaux	tropicale
tropiques	tropici
troupes	truppe
tunnel	tunnel
turbines	turbine
turcs	turchi
turque	turche
tyrannie	tirannia
tyran	tiranno
ukrainienne	ucraina
ukrainienne	ucraine
ukrainiens	ucraini
ukrainien	ucraino
unanime	unanime
unification	unificare
unification	unificazione
unifiée	unificato
unifié	unificata
unifié	unificato
uniformes	uniformi
unilatérale	unilaterale
union	unione
union	unioni
unique	unico
unitaire	unitaria
unitaire	unitario
unité	unità
universelle	universale
universelle	universali
universel	universale
universitaires	universitarie
universitaire	universitaria
universités	università
université	universitari
univers	universo
uranium	uranio
urbaine	urbana
urbain	urbana
urbain	urbani
urbanisme	urbanistica
urgent	urgenza
utiles	utili
utile	utile
utilisaient	utilizzavano
utilisant	utilizzando
utilisateurs	utilizzatori
utilisation	utilizzo
utilisées	utilizzate
utiliser	utilizzare
utilise	utilizza
utilisé	utilizzata
utilisé	utilizzato
utilité	utilità
utopique	utopia
vacance	vacante
vaccination	vaccinazione
vaccins	vaccini
vache	vacca
valables	valide
valeur	valore
vallée	valle
vanne	valvole
variables	variabili
variable	variabile
variait	variegato
variantes	varianti
variations	varianti
variation	variazioni
variée	variegata
varier	variare
variété	varietà
varie	varia
vassal	vassallo
vassaux	vassalli
végétales	vegetali
végétale	vegetale
végétarien	vegetariana
véhicules	autoveicoli
véhicules	veicoli
vendre	vende
vendue	venduta
vendu	venduto
vénérable	venerabile
verbales	verbali
vérification	verifica
vérifier	verifica
vérifier	verificare
vérifié	verificato
versions	versioni
version	versione
verte	verdi
verticalement	verticalmente
verticales	verticali
verticale	verticale
vestiges	vestigia
vétérinaire	veterinaria
vétérinaire	veterinario
victimes	vittime
victime	vittima
victoires	vittorie
victoire	vittoria
victorieux	vittorioso
vidéo	videogiochi
vierges	vergini
violence	violenta
violence	violenza
violentes	violenta
violente	violenta
violente	violenza
virale	virale
virgule	virgola
virtuelle	virtuali
virtuel	virtuale
virus	virus
visibilité	visibilità
visibles	visibili
visible	visibile
vision	visione
vision	visioni
visiter	visitare
visites	visite
visite	visita
visite	visitato
visite	visite
visuelle	visuale
vitales	vitali
vitalité	vitalità
vital	vitale
vitamine	vitamina
viticole	viticoltura
vocabulaire	vocabolario
volatils	volatili
volcanique	vulcanica
volcanique	vulcaniche
volcans	vulcani
volontaires	volontari
volontaire	volontari
volontaire	volontaria
volontaire	volontarie
volontariat	volontariato
volumes	volumi
volume	volume
votées	votati
voter	votare
voté	votato
vulgaire	volgare
vulnérabilité	vulnerabilità
vulnérables	vulnerabili
vulnérable	vulnerabile
wagons	vagoni
yougoslaves	jugoslavi
