аббас	abbas
абелян	abelian
абзацев	formats
абиджанская	abidjan
аборигенной	culture
абсолютного	absolute
абсорбента	certified
абсорбционного	absorption
абсорбционную	absorption
абстрактное	abstract
абстрактном	abstract
абстрактный	abstract
абстрактным	abstract
абудже	abuja
абуджийский	abuja
абуджу	abuja
авансами	advances
авансов	advances
авансы	advances
август	august
авеню	avenue
авиабагажа	shipment
авиарейсов	flights
авиатранспорт	island
австралией	australia
австралию	australia
австралия	australia
австрийскими	austrian
австрийское	austrian
австрия	austria
автомобилестроительная	motor
автомобилестроительной	automobile
автомобилестроителями	automobile
автономии	autonomy
автор	author
автора	author
авторском	copyright
агентам	agents
агентов	agents
агенты	agents
агилар	aguilar
аграрной	agrarian
аграрных	agrarian
агрессии	aggression
агрессию	aggression
адамс	adams
адамса	adams
адаптационным	adaptation
адаптационными	adaptation
адаптируем	adapting
адлера	adler
административные	administrative
администрациях	administrations
адольфо	adolfo
адольфом	adolphe
адсорбции	adsorption
адсорбция	adsorption
азербайджан	azerbaijan
азербайджане	azerbaijan
азиатскими	asian
азиатском	asian
азоту	nitrogen
аймара	aymara
академии	academy
академического	academic
академическое	academic
академической	academic
академиях	academies
аквакультура	aquaculture
аквакультуре	aquaculture
аквакультуры	aquaculture
аквикультуры	aquaculture
аккра	accra
аккредитации	accreditation
аккредитационный	accreditation
аккредитованным	accredited
аккредитованных	accredited
акосты	acosta
актива	asset
активом	asset
активы	assets
акцентирована	enough
акцепта	acceptance
акцептом	acceptance
акцизные	excise
албанией	albania
албукерки	albuquerque
алексис	alexis
алексиса	alexis
алексисом	alexis
ален	alain
алессандро	alessandro
алжирскими	algiers
алисон	alison
алисы	alice
алкоголем	alcohol
алкоголь	alcohol
алкоголю	alcohol
алкоголя	alcohol
аллен	allen
алматинская	almaty
алматинской	almaty
алматинскую	almaty
алматы	almaty
алфреду	lopes
альберт	albert
альберто	alberto
альваро	alvaro
альмейда	almeida
альтернативного	alternative
альтернативному	alternative
альтернативные	alternative
альфа	alpha
альфой	alpha
альфонсе	alphonse
альфред	alfred
альфредо	alfredo
альфы	alpha
альянса	alliance
альянсы	alliances
алюминиевые	aluminium
алюминий	aluminium
алюминия	aluminium
аляске	alaska
амазонской	amazon
амман	amman
аммане	amman
амманскую	amman
амстердам	amsterdam
амстердамский	amsterdam
аналитики	analysts
аналитиков	analysts
аналогичные	similar
анвара	anwar
ангильи	anguilla
ангилью	anguilla
ангилья	anguilla
англии	england
английском	english
англию	england
англия	england
ангола	angola
анголе	angola
анголой	angola
анголу	angola
андервуд	underwood
андерса	anders
андерсон	anderson
андес	andes
анджела	angela
анджеле	angela
анджелу	angela
анджелы	angela
андреа	andrea
андреас	andreas
андреаса	andreas
андресом	andrés
андрэ	andré
андские	andean
андского	andean
андское	andean
андском	andean
аните	anita
анкара	ankara
анкаре	ankara
аннотированная	annotated
аннотированную	annotated
антенных	antenna
антигуа	antigua
антидискриминационной	anti-discrimination
антидискриминационному	raise
антикоррупционного	anti-corruption
антиокия	antioquia
антисемитизмом	anti-semitism
антитрестовского	antitrust
антитрестовскому	antitrust
антони	anthony
антропогенном	distinct
антропология	anthropology
антуан	antoine
аотеароа	aotearoa
апартеида	apartheid
апелляционная	appeals
апостолическая	apostolic
апостольской	apostolic
апреле	april
апрель	april
апрельский	april
апреля	april
априори	priori
апробированы	tested
арабоязычные	escaping
аравией	arabia
аравия	arabia
арбитражу	arbitration
аргентина	argentina
аргентине	argentina
аргентинская	argentine
аргентинских	argentine
аргументируя	arguing
арестован	arrested
арестованы	arrested
ариел	ariel
ариела	ariel
аризона	arizona
аристид	aristide
аристида	aristide
аристиду	aristide
ариэлем	ariel
ариэль	ariel
ариэля	ariel
арктика	arctic
арктике	arctic
арктику	arctic
арктические	arctic
арктических	arctic
арктического	arctic
арменией	armenia
армения	armenia
армян	armenians
армяне	armenians
армянских	armenian
армянского	armenian
арнема	arnhem
артура	arthur
аруба	aruba
арубский	aruba
арубу	aruba
архивировать	archive
архитекторов	architects
архитекторы	architects
архитектуре	architecture
архитектуры	architecture
асбеста	asbestos
асеан	asean
ассамблее	assembly
ассамблеей	assembly
ассамблеи	assembly
ассамблея	assembly
ассоциативного	housing
ассоциациями	associations
астрофизика	astrophysics
астрофизике	astrophysics
аткинсон	atkinson
атланте	atlanta
атлантике	atlantic
атлантики	atlantic
атлантического	atlantic
атлас	atlas
атрибуции	attribution
аттила	attila
атторнеев	attorneys
аугусту	augusto
аудиоматериалов	audio
аудиоматериалы	audio
аудиофайлов	audio
аудиторскому	audit
афганистана	afghanistan
афганистане	afghanistan
афганистану	afghanistan
афганские	afghan
афганским	afghan
афганских	afghan
афганской	afghan
африка	africa
африканские	african
африканского	african
африканцев	africans
африканцы	africans
африкой	africa
аффилированы	affiliated
аэрокосмический	aerospace
аэрокосмических	aerospace
аэрокосмического	aerospace
аэрокосмической	aerospace
аэрокосмическую	aerospace
аэропорта	airport
аэропорту	airport
багамские	bahamas
багдад	baghdad
базировавшейся	constitutional
баланс	balance
баланса	balance
балансового	sheet
балканах	balkans
балканский	balkan
балканским	balkan
балтии	baltic
балтийских	baltic
балтийского	baltic
балтике	region
бамакской	bamako
бангкока	bangkok
бангкокского	bangkok
банкам	banks
банками	banks
банки	banks
баптистских	baptist
баптистской	baptist
барам	licensed
барбадоса	barbados
барбадосе	barbados
барбадосской	barbados
барбара	barbara
барбуда	barbuda
барбуде	barbuda
барбуды	barbuda
баронесса	baroness
баронессой	baroness
барри	barry
барриоса	barrios
барселоне	barcelona
барселонской	barcelona
барьерных	barrier
барьеров	barriers
батальону	battalion
батареек	batteries
батат	sweet
бахадур	bahadur
бахрейна	bahrain
бахрейне	bahrain
бедствующего	distressed
бездомной	homeless
бездомности	homelessness
бездомность	homelessness
бездомностью	homelessness
безнадзорности	neglect
безнадзорностью	homelessness
безнаказанность	impunity
безнаказанностью	impunity
безработица	unemployment
безработицы	unemployment
безработных	unemployed
бейкер	baker
бейрут	beirut
бейрута	beirut
бейруте	beirut
бейрутом	beirut
бейрутской	beirut
белград	belgrade
белграда	belgrade
белградскую	belgrade
белграду	belgrade
белиз	belize
белиза	belize
белизу	belize
беллами	bellamy
белфаст	belfast
белфасте	belfast
белфастское	belfast
бельгии	belgium
бельгийские	belgian
бельгийскими	belgian
бельгийских	belgian
бельгийского	belgian
бендер	bender
бенджамин	benjamin
бенджамина	benjamin
бенефициар	beneficiary
бенефициарам	beneficiaries
бенефициарий	beneficiary
бенефициариями	beneficiaries
бенефициаров	beneficiaries
бенин	benin
бенине	benin
бентического	benthic
бентической	benthic
берберам	december
беременеют	pregnant
беременны	pregnant
беременные	pregnant
беременных	pregnant
берлин	berlin
берлине	berlin
берлинских	berlin
берлинской	berlin
бермудских	bermuda
бернанду	bernardo
бернарду	bernardo
бернару	bernard
бернда	bernd
бернской	berne
бернскую	berne
бертраном	bertrand
беспокоящей	burning
беспрецедентного	unprecedented
беспрецедентной	unprecedented
беспрецедентные	unprecedented
беспрецедентный	unprecedented
беспрецедентных	unprecedented
беспризорники	street
беспристрастной	impartial
беспристрастном	impartial
беспристрастностью	impartiality
беспристрастных	impartial
бесчеловечного	inhuman
бесчеловечное	inhuman
бесчеловечным	inhuman
бёрнс	burns
библиография	bibliography
библиотечному	library
библиотечных	library
биогенного	nutrient
биологии	biology
биологическом	biological
биомассой	biomass
биомассу	biomass
биомассы	biomass
биоразнообразии	biodiversity
биоразнообразия	biodiversity
биотехнологии	biotechnology
биотехнология	biotechnology
благодарим	thank
благодарю	thank
благотворными	beneficial
ближнем	middle
близились	completion
близлежащего	nearby
блэз	blaise
блэза	blaise
богатства	wealth
богатствами	wealth
богатствах	wealth
богооткровенные	revealed
болгарии	bulgaria
болгарию	bulgaria
болгария	bulgaria
болгарские	bulgarian
болгарскими	bulgarian
болгарских	bulgarian
болгарской	bulgarian
боливию	bolivia
боливия	bolivia
болтон	bolton
болтона	bolton
больницу	hospital
больничного	hospital
больничной	hospital
больничными	hospital
бомбометаний	bombing
борисом	boris
борнео	borneo
боснии	bosnia
боснийские	bosnian
боснийского	bosnian
боснию	bosnia
босния	bosnia
бостон	boston
ботинок	shoes
ботсвана	botswana
ботсване	botswana
ботулизма	surveillance
бош	bosch
бошем	bosch
брадфорд	bradford
бразилианской	brasilia
бразилианскую	brasilia
бразильских	brazilian
брайан	brian
брайен	brian
брайена	bryan
бракоразводном	divorce
брат	brother
братислава	bratislava
братьям	brothers
брауном	brown
бремен	bremen
бриджтауне	bridgetown
бристольский	bristol
британского	british
брифинг	briefing
брифингам	briefings
брифинги	briefings
бронзовых	bronze
брукингса	brookings
брукингского	brookings
брэдфорде	bradford
брэдфордского	bradford
брюсселе	brussels
брюссельских	brussels
брюссельской	brussels
брюссельскую	brussels
будапеште	budapest
будапештской	budapest
буддистские	buddhist
буддистских	buddhist
буддистской	buddhist
будущему	future
будущие	future
бульвар	boulevard
бумагах	securities
бурунди	burundi
бутан	bhutan
бухаре	bukhara
бухареста	bucharest
бухаресте	bucharest
бухгалтерского	accounting
буэн	shepherd
бывшего	former
бывшей	former
бытовое	domestic
валенсиа	valencia
валенсия	valencia
валле	valle
валлис	valais
валье	valle
валютного	monetary
валютный	monetary
валютным	monetary
ванкувера	vancouver
ванкувере	vancouver
варелы	varela
вариациями	variations
варшаве	warsaw
варшавской	warsaw
варьирующимся	ranging
вашингтон	washington
вашингтоне	washington
вашингтонского	washington
вашингтонскому	washington
вашингтону	washington
вводящую	misleading
ввозящие	traders
ведающее	charge
века	century
веке	century
веллингтон	wellington
веллингтоне	wellington
вена	vienna
венгерское	hungarian
венесуэле	venezuela
венесуэлу	venezuela
венецианская	venice
венеции	venice
венская	vienna
венскую	vienna
венчурного	venture
венчурные	venture
веракрус	veracruz
вергельда	blood
вертикальной	vertical
вертикальному	vertical
вертикальных	vertical
вертолетную	helicopter
верфях	yards
весенних	spring
весной	spring
вестибюле	lobby
ветвях	branches
ветеринарные	veterinary
ветеринарными	veterinary
веяниями	developments
взаимовыгодны	beneficial
взаимовыгоды	benefit
взаимозависимого	interdependent
взаимозависимость	interdependence
взаимозависимую	interdependent
взаимозависимы	interdependent
взаимозависимыми	interdependent
взаимозависимых	interdependent
взаимоисключающих	exclusive
взаимообменов	exchanges
взаимопониманию	understanding
взаимосогласованной	mutually
взаимоуважение	mutual
взаимоусиливающими	reinforcing
взвешиваниях	measurements
взлетающими	flying
взрывания	explosives
взрывными	explosive
взрывных	explosive
взрывоопасным	explosive
взрывоопасных	explosive
взыскиваются	recovered
взяточничество	bribery
взяточничеством	bribery
видения	vision
видеоматериалам	video
видеосвязи	video
видеосвязь	video
видеотехники	video
видимым	visible
видоизмененную	modified
видоизмененным	modified
виейра	vieira
виейре	vieira
виейрой	vieira
визитов	visits
визуального	visual
визуальное	visual
визуальному	visual
виллу	villa
вильнюс	vilnius
вильнюса	vilnius
вильнюсской	vilnius
вильсона	wilson
вильсоновском	wilson
виндхукская	windhoek
виниловых	vinyl
виннипег	winnipeg
виннипеге	winnipeg
винсенте	vicente
виргинии	virginia
виргинские	virgin
виргинских	virgin
виртуальной	virtual
виртуальными	virtual
вирхиния	virginia
висенте	vicente
вифлеем	bethlehem
вифлееме	bethlehem
вкб	unhcr
вкладчиками	pioneer
влажность	humidity
вмененного	implied
вмешательствам	interventions
вмешаются	intervene
внезапные	sudden
внесудебных	extrajudicial
внешние	external
внутриперемещенных	internally
внутриполитический	dimension
внутриполитическими	exploit
водитель	driver
водоподачи	carrier
водосберегающих	fertilizers
водоснабжение	water
водотоков	watercourses
военной	military
военнопленных	prisoners
возбудив	bringing
возбудитель	agent
возвращенного	returned
возобновил	resumed
возобновленной	resumed
возобновленному	renewal
возобновляемых	renewable
возражавших	strongly
возразило	objected
волостей	counties
вооруженном	armed
вопросник	questionnaire
вопросника	questionnaire
вопросники	questionnaires
вопросников	questionnaires
восемь	eight
воспитавшим	raised
воспринимаемых	perceived
воспринимала	roman
восточноевропейских	eastern
востребуемой	claimed
восьми	eight
восьмого	eighth
восьмые	eighth
врагом	enemy
враждебные	hostile
вредной	harmful
всемирной	world
всенародного	popular
всеобщей	universal
всеобъемлющего	comprehensive
всеобъемлющее	comprehensive
всеобъемлющие	comprehensive
всеобъемлющий	comprehensive
всеохватный	inclusive
встречавшихся	consensus
вступающему	incoming
вторичных	secondary
вторник	tuesday
втяжка	bullet
вука	unpublished
въезжало	guatemala
выбираясь	escaping
выборных	elected
выбросили	threw
вывезенными	diamonds
выверенным	reconciling
вывозки	remove
выгодах	benefits
выгружено	discharged
выездные	visiting
выживанию	survival
выживания	survival
вызовы	challenges
вызывался	globe
выкупаются	purchased
вымиранию	extinction
вымогательств	extortion
вынесшей	record
выносимое	rendered
выпавшим	happened
выпавшую	discharge
выпадать	locked
выписывались	defending
выращенные	produced
вырублен	solar
высказывавшаяся	raised
выслушанными	heard
выслушивались	heard
выслушиваются	heard
высокоорганизованных	highly
высокопродуктивного	potentials
высокоразвитой	highly
выставило	payment
выставочных	exhibition
выступая	speaking
высылающее	removing
вычеркнут	struck
вышеозначенной	capacities
выявленному	customer
выявлял	train
выявляя	identifying
вьетнамцев	vietnamese
гааге	hague
гаагская	hague
гаагских	hague
гаагского	hague
габриэлой	gabriela
габриэлу	gabriela
габриэлы	gabriela
гаванской	havana
гаванскую	havana
гаинс	gains
гаитянским	haitian
гайане	guyana
гамбию	gambia
гамбия	gambia
гамбург	hamburg
гамбурге	hamburg
гамбургскими	hamburg
гамбургских	hamburg
гана	ghana
гане	ghana
гарвардской	harvard
гармонии	harmony
гармоничности	harmony
гашишем	application
гвардии	guard
гвинее	guinea
гвинеей	guinea
гвинею	guinea
гельмут	helmut
гендерного	gender
гендерным	gender
генеральная	general
генеральной	general
генерируя	generating
генетические	genetic
генетического	genetic
генетической	genetic
генетическую	genetic
генома	genome
геномики	genomics
геномом	genome
геноцид	genocide
генте	ghent
генуе	genoa
геодезистов	surveyors
геологии	geology
геология	geology
геометрических	geometric
геометрического	geometric
геостационарную	geostationary
геофизическим	geophysical
геофизическими	geophysical
геофизических	geophysical
геохимического	languages
герба	emblem
герберт	herbert
германской	german
герметизированы	sealed
героина	heroin
герхард	gerhard
герхарда	gerhard
герцеговина	herzegovina
герцеговине	herzegovina
герцеговину	herzegovina
герцогство	duchy
гётеборгского	gothenburg
гётеборгскому	gothenburg
гёттинген	göttingen
гибким	flexible
гибких	flexible
гибкости	flexibility
гибралтар	gibraltar
гибралтаре	gibraltar
гибралтаром	gibraltar
гибралтару	gibraltar
гибридного	hybrid
гибридное	hybrid
гибридных	hybrid
гибридом	hybrid
гибсон	gibson
гидо	guido
гидравлическое	hydraulic
гидрографическим	hydrographic
гидрографических	hydrographic
гидрографического	hydrographic
гидрографическом	hydrographic
гидрологии	hydrology
гидрологических	hydrological
гидрологическую	hydrological
гидрологию	hydrology
гидрология	hydrology
гилпин	gilpin
гильермо	guillermo
главах	chapters
гладкой	smooth
глазго	glasgow
гласным	transparent
гласными	transparent
глобализацией	globalization
глобализация	globalization
глобализуемой	modern
глобально	globally
глобальной	global
глобальном	global
глобальную	global
глобе	globe
глория	gloria
глоссария	glossary
говарда	howard
годовщине	anniversary
годовщиной	anniversary
годовщины	anniversary
голландским	dutch
голландского	dutch
голые	naked
гондурасе	honduras
гондурасом	honduras
гондурасу	honduras
гонсалеса	gonzález
горнодобывающих	mining
горнодобычи	export
гостиницей	hotel
государствам	states
государстве	state
государством	state
грабежам	looting
гражданствами	nationalities
грамотам	counted
грамотности	literacy
гранада	granada
граната	grenade
гранде	grande
грантам	grants
графическом	graphic
графствах	counties
грационный	grace
гренадин	grenadines
гренадинах	grenadines
гренландии	greenland
гренобль	grenoble
грецию	greece
греческие	greek
греческих	greek
греческой	greek
греческом	greek
греческую	greek
гринпис	greenpeace
грудки	breast
грудку	thighs
грудь	chest
грузин	georgians
грузинами	georgians
грузинская	georgian
грузинские	georgian
грузинскими	georgian
грузинских	georgian
грузинской	georgian
грузинскую	georgian
грузины	georgians
грузится	loaded
грузиться	loaded
грузовики	trucks
грузовиком	truck
грузовладельцами	cargo
грузовладельцем	cargo
грэм	graham
грэнд	grand
грэхем	graham
грязная	dirty
грязного	dirty
губернаторов	governors
губернатором	governor
гугл	google
гуманитарного	humanitarian
гуманитарной	humanitarian
гуманитарную	humanitarian
гуманитарным	humanitarian
гуманитарными	humanitarian
гуманитарных	humanitarian
гуманностью	humane
густаво	gustavo
гутиеррес	gutiérrez
гутьерес	gutiérrez
гутьеррес	gutiérrez
гутьерресом	gutiérrez
гэлакси	galaxy
гэллапа	gallup
давнишнего	long-standing
дакаре	dakar
дакарские	dakar
дакарских	dakar
дакка	dhaka
даккской	dhaka
дальнейшие	further
дамаска	damascus
дамасскую	damascus
дампинг	dumping
данило	danilo
даниэла	daniela
даниэлю	daniel
дания	denmark
даньел	daniel
дарении	gifts
дарственного	endowment
дарственный	endowment
дарфур	darfur
дарфура	darfur
дары	gifts
датским	danish
датское	danish
датскую	danish
двенадцатой	twelfth
двенадцатом	twelfth
двенадцатый	twelfth
двигателя	engine
движениями	movements
движениях	movements
движителями	drive
движущееся	brake
двойных	double
двуокиси	dioxide
двустороннего	bilateral
двустороннем	bilateral
двусторонних	bilateral
двухстороннем	bilateral
двуязычном	bilingual
девочками	girls
девятого	ninth
девятом	ninth
девятые	seventh
деградацией	degradation
дежурную	guaranteeing
дежурств	establishing
декларацией	declaration
делегатов	delegates
делегаты	delegates
деловитостью	efficiency
деловых	business
дельта	delta
демаре	sophie
демаркационных	lines
демаршем	linking
демобилизацией	demobilization
демобилизацию	demobilization
демобилизовавшихся	demobilized
демобилизованным	demobilized
демобилизованных	demobilized
демократией	democracy
демократизация	democratization
демократии	democracy
демократий	democracies
демократического	democratic
демократическом	democratic
демократичное	democratic
демократичностью	democratic
демократичными	democratic
демократиями	democracies
демонстрантами	demonstrators
демонстранты	demonstrators
демонстрационным	demonstration
демонстрационных	demonstration
демонстрациям	demonstrations
демонстрациями	demonstrations
дени	denis
деннис	dennis
денонсировать	denounce
департамента	department
департаментские	departmental
департаментской	departmental
департаментском	departmental
депозитам	deposits
депозитами	deposits
депозитах	deposits
депозитов	deposits
депонировано	deposited
депривация	deprivation
деревне	village
деревянные	wooden
деревянный	wooden
дерегулированию	deregulation
дерегулирования	deregulation
держав	powers
держава	power
державами	powers
державой	power
державу	power
держатель	holder
держателя	holder
дестимулирует	discourage
десятого	tenth
десятом	tenth
детализировано	detailed
децентрализацией	decentralization
децентрализация	decentralization
децентрализованного	decentralized
децентрализованной	decentralized
децентрализованных	decentralized
джакарте	jakarta
джакартский	jakarta
джакартского	jakarta
джакарты	jakarta
джамал	jamal
джангл	offshore
джанет	janet
джейкоб	jacob
джейсон	jason
дженифер	jennifer
дженкинс	jenkins
дженнифер	jennifer
джеральд	gerald
джерард	gerard
джереми	jeremy
джерси	jersey
джолли	jolly
джонатан	jonathan
джонсон	johnson
джорджтаунский	georgetown
джохан	johan
джулиан	julian
джулиана	julian
джулиусом	julius
джульяна	julian
диагностические	diagnostic
диалог	dialogue
диалога	dialogue
диалогах	dialogues
диаспору	diaspora
диаспоры	diaspora
дидье	didier
дилемме	dilemma
дилеров	dealers
дилеры	dealers
динамична	dynamic
динамичную	dynamic
динамичные	dynamic
динамичных	dynamic
динкорп	potentially
диоксид	dioxide
дипломат	diplomat
дипломата	diplomat
дипломатии	diplomacy
дипломатические	diplomatic
дипломатическим	diplomatic
дипломатических	diplomatic
дипломатическом	diplomatic
дипломатическую	diplomatic
дипломатию	diplomacy
дипломату	diplomat
дипломную	thesis
директиве	directive
директивой	directive
директор	director
дирхама	dealing
дискретно	secretly
дискриминационных	discriminatory
дислокацией	strictly
диспергированных	particles
дистанционному	remote
дистилляции	distillation
дистрибьюторские	distribution
дисциплинарную	disciplinary
дисциплинарные	disciplinary
дитер	dieter
дитера	dieter
диффамации	defamation
диффамацию	defamation
диффамация	defamation
дифференцированной	differentiated
дну	seabed
добавил	added
добавочного	spill
доброволец	volunteer
добровольные	voluntary
добровольческое	volunteer
добросовестностью	integrity
добывающую	mining
доведенной	brought
доводимые	brought
доводимым	brought
договаривающемся	contracting
договаривающиеся	contracting
договаривающихся	contracting
доиндустриальный	estimation
доказавших	proven
доклад	report
докладе	report
докладных	chambers
докладчика	rapporteur
докладчиком	rapporteur
доктрине	doctrine
документация	documentation
долине	valley
доменное	domain
доминика	dominica
доминиканской	dominican
доминике	dominica
доминикой	dominica
домогательств	harassment
домогательства	harassment
домогательствами	harassment
домогательство	harassment
дональд	donald
дональда	donald
донецкий	donetsk
донецкой	donetsk
донорам	donors
донорского	donor
доноры	donors
дополнениям	elaboration
дополняемая	supplemented
дополняемом	supplemented
допущений	assumptions
допущениях	assumptions
доставивших	observing
достоинства	dignity
достопочтенного	honourable
дотационного	endowment
дочерям	daughters
дочь	daughter
драматичные	dramatic
драшковича	unpublished
дрезден	dresden
дрездене	dresden
дровяных	stoves
другими	other
дружбу	friendship
дружбы	friendship
дружественные	friendly
друзей	friends
друзья	friends
друзьям	friends
друзьями	friends
дубайской	dubai
дубая	dubai
дублин	dublin
дублине	dublin
дублинская	dublin
дублировало	duplicate
дублируемых	collections
дугласа	douglas
дугласом	douglas
дунае	danube
дунаем	danube
дунай	danube
дунайская	danube
дунаю	danube
дуная	danube
дурбан	durban
дурбанской	durban
духовное	spiritual
духовную	spiritual
дым	smoke
дыма	smoke
дымовая	cover
дыхательный	breathing
дэвида	david
дэвис	davis
дюссельдорфа	düsseldorf
еврейскими	jewish
еврейских	jewish
еврейской	jewish
европарламента	smart
европе	europe
европейским	european
европейского	european
египет	egypt
египте	egypt
египтом	egypt
единообразного	uniform
единообразные	uniform
единообразными	uniform
единства	unity
ежегодного	annual
ежегодные	annual
ежегодный	annual
ежегодных	annual
ежедневных	daily
ежеквартального	quarterly
ежеквартальное	quarterly
ежеквартальной	quarterly
ежеквартальные	quarterly
ежеквартальных	quarterly
ежемесячного	monthly
ежемесячной	monthly
ежемесячном	monthly
еженедельные	weekly
еженедельных	weekly
ел	constitutions
елизаветы	elizabeth
епархии	diocese
епархия	diocese
епископ	bishop
епископа	bishop
жак	jacques
жаклин	jacqueline
жаку	jacques
жандармерию	gendarmerie
жандармом	policeman
желтая	yellow
желтой	yellow
женатого	married
женевским	geneva
женевских	geneva
женевы	geneva
женераль	générale
жертве	victim
жесток	cruel
жестокостях	atrocities
живорождений	births
животноводческие	livestock
животный	animal
жившим	pressed
живьем	alive
жидкие	liquid
жидким	liquid
жидкость	liquid
жизнеспособной	viable
жизнеспособных	viable
жизнях	lives
жилищного	housing
жиль	gilles
жильбер	gilbert
жильбера	gilbert
жозефом	joseph
жонасом	jonas
жоржа	georges
жоржу	georges
жуана	joão
журналист	journalist
журналиста	journalist
журналистами	journalists
журналисты	journalists
забастовке	strike
заботах	concerns
заботящееся	being
забытая	forgotten
забыто	forgotten
забытых	forgotten
заверенных	certified
завещаниях	wills
завоеваниями	gains
завтра	tomorrow
завтрашнего	tomorrow
загнать	drive
загорающегося	operator
заготовкой	logging
загреб	zagreb
загребе	zagreb
загружается	loaded
заживо	alive
зажигается	activated
зазору	clearance
заида	zayed
заказников	reserves
заканчивающегося	ending
заканчивающуюся	addresses
закладыванию	laying
заключительный	final
законнорожденные	legitimate
закончившейся	ending
закончивший	their
закрепится	surplus
закреплённых	enshrined
закрытая	closed
закрыты	closed
закупаемым	generated
закуплен	purchased
заливается	fluid
заложение	deployment
замалчиванию	silence
заменены	replaced
замерочную	measuring
замещающей	replacement
замещен	replaced
заминирована	mined
заминированных	mined
замкнутую	closed
заммита	bryan
замороженным	frozen
замороженных	frozen
заморские	overseas
заморской	overseas
замужних	married
занесли	territories
заносилась	database
занятости	employment
заострялись	limited
западноевропейских	western
запломбированном	sealed
заполненным	filled
заполнены	filled
запрашиваемое	requested
запрашивающего	requesting
запрашивающим	requesting
запретившей	prohibits
запрещаемых	chemistry
запрещенную	prohibited
запусками	launch
запускающего	launching
запускающих	launching
запястьях	wrists
заработают	daughters
зараженной	contaminated
зарезервирована	reserved
зарезервировано	reserved
зарезервированы	reserved
засвидетельствован	certified
заседании	meeting
заседающем	sitting
заседающим	sitting
заседающих	parliamentary
засекреченных	sealed
заселением	forcible
засильем	prevalence
заслушала	heard
заслушанной	heard
заслушанным	heard
заслушано	heard
засухе	drought
затраченном	spent
затянутого	lengthy
затянутые	prolonged
зачастую	often
зачатия	conception
зачисляемости	learning
защищаемых	protected
зверства	atrocities
здоровее	skilled
здоровье	health
здравой	sound
здравоохранения	health
зеландией	zealand
зеландии	zealand
зеландия	zealand
зеленое	green
зеленому	green
зеленым	green
зеленых	green
землетрясением	earthquake
зимнего	winter
зимние	winter
зимний	winter
зимних	winter
зиму	winter
злоупотребило	supposed
злоупотребляла	rather
знакомящих	technologies
знаменовал	marked
золотому	golden
зондированию	sensing
зондирования	sensing
зоран	zoran
зорана	zoran
зримого	visible
зримости	visibility
зримых	yield
зубоврачебного	dental
зятя	brother-in-law
ибрагима	ibrahim
ибрахим	ibrahim
иврит	hebrew
ивуарийским	ivorian
ивуарийскими	ivorian
ивуарийское	ivorian
ивуарскими	ivorian
игнас	confederation
игнорированы	ignored
идентификационном	manual
идентифицировав	identifying
идентичного	identical
идентичной	identical
идентичности	identity
идентичные	identical
идентичными	identical
идеями	ideas
иерархией	hierarchy
иерусалим	jerusalem
иерусалима	jerusalem
иерусалиме	jerusalem
иерусалимом	jerusalem
иждивение	support
избегало	avoid
избежит	escape
избираемых	elected
избранных	elected
известняк	limestone
извинение	apology
извинением	apology
извлеченной	encountered
извращенной	perverse
издано	issued
издевались	humiliated
излагающего	paper
излагающих	setting
излишнем	unnecessary
измеряемым	measured
измеряется	measured
изображались	messages
изобразительной	image
изолированного	isolated
изомеры	isomers
израиль	israel
израильскими	israeli
израильских	israeli
израильского	israeli
израсходованного	spent
изучаемом	within
изучаемый	studied
иисус	jesus
иисуса	jesus
иллинойс	illinois
имена	names
имитационная	simulation
иммигрантами	immigrants
иммигрантских	immigrant
иммигрантского	immigrant
иммиграцией	immigration
иммиграционного	immigration
иммиграционную	immigration
иммунитете	immunity
имплементирующие	implementing
имплицитные	implicit
импортирован	imported
импортироваться	imported
импортируемого	imported
импортируются	imported
импортирующего	importing
импортирующих	importing
импортном	import
импортному	import
имущественной	estate
инвентарные	inventory
инвестиционного	investment
инвестиционной	investment
инвестор	investor
инвесторами	investors
индейскими	indian
индекс	index
индиана	indiana
индивидуально	individually
индии	india
индийского	indian
индию	india
индия	india
индонезией	indonesia
индонезийские	indonesian
индонезийскими	indonesian
индонезийских	indonesian
индонезийского	indonesian
индонезийское	indonesian
индуистских	hindu
индуистского	hindu
индуистской	hindu
индусских	hindu
индусского	hindu
инженер	engineer
инженерии	engineering
инициативах	initiatives
инициативному	proactive
инициируются	initiated
инклюжн	adopt
инклюзивное	inclusive
инклюзивной	inclusive
инклюзивную	inclusive
инклюзивных	inclusive
инновационной	innovation
инновацию	innovations
инновациям	innovation
иностранками	foreign
иностранной	foreign
иностранных	foreign
инсбрука	innsbruck
инспекционной	inspection
инспекциям	inspection
институционального	institutional
институциональные	institutional
институциональным	institutional
институциональными	institutional
институционной	institutional
инструктировал	austria
интел	intel
интеллектуальную	intellectual
интеллектуальными	intellectual
интерактивные	interactive
интерактивными	interactive
интерактивных	interactive
интервенций	interventions
интересные	interesting
интермодальных	intermodal
интернационализацией	internationalization
интернирования	internment
интернированными	interned
интерпол	interpol
интерфейт	interfaith
инфекций	infections
инфляции	inflation
информатике	informatics
информировав	informing
информировалась	properly
информирован	informed
информирующая	coordination
инцидент	incident
инцидента	incident
инциденты	incidents
инъецируемыми	injecting
иокогаме	yokohama
иокогамской	yokohama
иорданией	jordan
иордании	jordan
иорданский	jordanian
иорданским	jordanian
иорданских	jordanian
иорданской	jordanian
иракских	iraqi
иракской	iraqi
иракцы	iraqis
иранские	iranian
иранской	iranian
ирене	irene
ирландского	irish
ирригации	irrigation
ирригационное	irrigation
ирригационные	irrigation
ирригационных	irrigation
ирригация	irrigation
ирэн	irene
исабель	isabel
искажались	claimed
искажена	distorted
искаженный	distorted
искаженными	distorted
исключенность	exclusion
искоренено	eradicated
ислам	islam
ислама	islam
исламабад	islamabad
исламабада	islamabad
исламабаде	islamabad
исламе	islam
исламская	islamic
исламских	islamic
исламской	islamic
исламу	islam
испанского	spanish
испанском	spanish
исповедующей	adopts
исполнило	comply
исполнительной	executive
исполнительном	executive
исполнительному	executive
исполнительный	executive
исполняющая	performing
исполняющей	performing
исполняющих	performing
исследователи	researchers
исследовательских	research
истекла	substantial
истины	truth
истолковывал	interpreted
истории	history
исчез	disappeared
исчерпает	exhausted
италиа	italia
италию	italy
итальянский	italian
итальянским	italian
итальянскими	italian
итальянского	italian
итальянское	italian
йеменские	yemeni
йеменскими	yemeni
йеменского	yemeni
йохан	johan
йоханнесбургские	johannesburg
йоханнесбургского	johannesburg
йоханнесбургской	johannesburg
йоханнесбургском	johannesburg
йоханнесбургскую	johannesburg
кабинета	cabinet
кабир	kabir
кабул	kabul
кабула	kabul
кабуле	kabul
кабулом	kabul
кавказа	caucasus
кавказе	caucasus
кавказского	caucasus
кадира	qadir
кадмий	cadmium
каждодневно	daily
каждые	every
кажущееся	apparent
казарм	barracks
казармы	barracks
казахстане	kazakhstan
казначейства	treasury
казнен	executed
казнях	executions
каире	cairo
каирская	cairo
каирской	cairo
кайма	surrounded
каймановы	cayman
каледонией	caledonia
календарного	calendar
календарном	calendar
календарными	calendar
календарных	calendar
калечащие	genital
калечением	female
калиброванной	calibration
калибровку	calibration
калифорния	california
калорифера	radiator
камаль	kamal
камаля	kamal
камачо	camacho
камбоджа	cambodia
камбоджи	cambodia
камбоджийские	cambodian
камбоджийскими	cambodian
камбоджийских	cambodian
камбоджийского	cambodian
камерон	cameron
камеруна	cameroon
камило	camilo
кампала	kampala
кампале	kampala
кампалой	kampala
кампалу	kampala
кампальский	kampala
кампальском	kampala
канада	canada
канаде	canada
канадское	canadian
канадской	canadian
канадцев	canadians
канадцы	canadians
канарские	canary
канберра	canberra
канберре	canberra
канберрского	canberra
каннабис	cannabis
кантональной	cantonal
кантональном	cantonal
кантональные	cantonal
кантональным	cantonal
кантональными	cantonal
кантональных	cantonal
кантоном	canton
канцелярии	office
канцлер	chancellor
капитала	capital
капиталам	capital
капитализм	capitalism
капиталоемкости	intensity
капиталу	capital
капитан	captain
каракас	caracas
каракасской	caracas
карательный	punitive
кардозу	cardoso
карибском	caribbean
карим	karim
кариму	karim
каритас	caritas
карлос	carlos
карлоса	carlos
карлуш	carlos
карлуша	carlos
кармана	pocket
карманные	pocket
кармен	carmen
карнеги	carnegie
карол	carol
карранса	carranza
картахена	cartagena
картахене	cartagena
картахенский	cartagena
картахенским	cartagena
картахенского	cartagena
картахенской	cartagena
картахенском	cartagena
касабланке	casablanca
кассетными	cluster
кастильо	castillo
кастовой	caste
кастро	castro
каталитическую	catalytic
каталога	catalogue
каталогом	catalogue
катанга	katanga
катанге	katanga
катанги	katanga
катаре	qatar
катарина	katarina
катманду	kathmandu
католиком	catholic
католические	catholic
католическим	catholic
католическими	catholic
католической	catholic
катрин	catherine
каучук	rubber
каучуковых	rubber
качество	quality
кашмире	kashmir
кашмиру	kashmir
квадратных	square
квартале	quarter
квартальной	quarterly
квартальные	quarterly
квартальный	quarterly
квартальных	quarterly
квартире	apartment
квартирой	apartment
квартиру	apartment
квинсленде	queensland
квитанцией	warehouse
кельн	köln
кельнской	cologne
кенией	kenya
кенийском	kenyan
кенийцами	kenyan
кению	kenya
кеннет	kenneth
керри	kerry
кёльнской	cologne
киберпространства	cyberspace
киберпространство	cyberspace
кимберлийского	kimberley
кингстон	kingston
кингстоне	kingston
кингстонскую	kingston
киншасу	kinshasa
киншасы	kinshasa
киото	kyoto
киотский	kyoto
киотского	kyoto
киотской	kyoto
кипр	cyprus
кипра	cyprus
кипре	cyprus
киргизия	kyrgyzstan
киргизской	kyrgyz
кирибати	kiribati
кислорода	oxygen
кислотами	acids
китае	china
китай	china
китайском	chinese
китая	china
кито	quito
клайв	clive
клайн	klein
классифицировали	classified
классовых	class
кластерного	cluster
клаудиа	claudia
клаудио	claudio
клаудия	claudia
клаус	klaus
клаусу	klaus
клевера	clover
клемент	clement
климата	climate
климатическом	climatic
клиник	clinics
клинических	clinical
клод	claude
клонирования	cloning
кляйн	klein
книг	books
княжества	principality
княжестве	principality
княжество	principality
княжеством	principality
коалицией	coalition
коалиционным	coalition
кодексам	codes
кодексов	codes
кодексы	codes
кодификации	codification
кодификационными	codification
кожаные	leather
кожаных	leather
кожевенной	leather
кожевенные	leather
коленями	knees
колина	colin
колледж	college
колледжа	college
коллективно	collectively
коллективной	collective
коллективную	collective
коллективные	collective
коллективных	collective
коллекциях	collections
колодцы	wells
колониализма	colonialism
колониальным	colonial
колонией	colony
колонка	column
колонку	column
колорадо	colorado
колумбийскими	colombian
кольце	shown
кольцу	geostationary
командах	teams
командирам	commanders
командирами	commanders
командной	command
командном	command
командование	command
командующего	commander
командующих	commanders
комбинированию	combine
комиссара	commissioner
комиссий	commissions
комиссиях	commissions
комитетами	committees
комитетах	committees
комитеты	committees
комментируя	commenting
коммерциализацию	commercialization
коммуникационном	communication
коммунистическим	communist
коммунистического	communist
коммунистической	communist
коммутируемой	install
компаративные	comparative
компендиум	compendium
компенсировалась	offset
компетентные	competent
компетентным	competent
компетентными	competent
компилировали	compile
компилятивный	compilation
компромиссу	compromise
компьютеры	computers
конвенций	conventions
конвенция	convention
конвенциями	conventions
конвергенцией	convergence
конвергенции	convergence
конвергенция	convergence
конверсию	conversion
конголезские	congolese
конголезскими	congolese
конголезской	congolese
конгресс	congress
конгрессе	congress
конгрессмена	congressman
конкретизированных	strengthened
конкурентные	competitive
конкурентоспособная	competitive
конкурентоспособного	competitive
конкурентоспособной	competitive
конкурентоспособными	competitive
конкурентоспособных	competitive
конкурирующего	competing
конкурирующим	competing
конкурсному	competitive
конной	mounted
коннор	connor
консенсус	consensus
консенсуса	consensus
консенсусом	consensus
консолидированных	consolidated
консорциума	consortium
конституции	constitution
конституционного	constitutional
конституционностью	constitutionality
конституционные	constitutional
конституционными	constitutional
конституционных	constitutional
конституциям	constitutions
конструктивизма	constructive
конструкционной	structural
консульские	consular
консульским	consular
консульских	consular
консульского	consular
консульское	consular
консульстве	consulate
консультантах	consultants
консультирующие	advising
контейнер	container
контейнерах	containers
контейнере	container
контекстам	contexts
контекстах	contexts
контекстов	contexts
континентального	continental
континентальном	continental
контрактному	contract
контракторов	contractors
конфедерацией	confederation
конфедерации	confederation
конфедерация	confederation
конференцией	conference
конференций	conferences
конференция	conference
конференциям	conferences
конференциях	conferences
конфиденциальному	confidential
конфиденциальные	confidential
конфискованного	confiscated
концентрационных	concentration
концептуализацию	designing
концептуальных	conceptual
концессионного	concession
концессионном	concession
концессионный	concession
концессионным	concession
концессия	concession
концессиям	concessions
кооперативах	cooperatives
кооперативе	cooperative
кооперативном	cooperative
кооперативным	cooperative
копенгаген	copenhagen
копенгагене	copenhagen
копенгагенская	copenhagen
коралловых	coral
корвин	corwin
кордильер	cordillera
корейском	korean
коридор	corridor
коридоры	corridors
кормильце	household
кормовой	stern
корнях	roots
королева	queen
королевским	royal
королевскими	royal
королевское	royal
королевства	kingdom
коронерское	inquest
короной	crown
короны	crown
корпоративном	corporate
корпоративную	corporate
корпоративные	corporate
корпоративными	corporate
корпоративных	corporate
корректный	choice
корреляционную	correlation
коррозии	corrosion
коррумпированным	corrupt
коррупцией	corruption
коррупция	corruption
корфу	corfu
косвенной	indirect
космическую	space
космосу	space
косово	kosovo
костариканских	rican
котлоагрегатах	boilers
кочабамба	cochabamba
коэн	cohen
краеугольного	cornerstone
кража	theft
краска	paint
кратки	brief
кратном	valid
креветок	shrimp
крейг	craig
кризис	crisis
кризиса	crisis
кризисах	crises
кризису	crisis
кризисы	crises
криминалистике	criminology
криминалистов	criminal
криминальных	criminal
криса	chris
крисом	chris
кристофер	christopher
критерии	criteria
критикал	reaching
кришна	krishna
кришны	krishna
крове	shelter
кровепродуктов	blood
крову	shelter
кроуфорд	crawford
круглых	tables
круговую	circular
круизных	cruise
крупномасштабного	large-scale
крупномасштабные	large-scale
крылатые	cruise
крылатых	cruise
крыльями	wings
крымские	crimean
крымских	crimean
ксавьер	xavier
кубинские	cuban
кубинского	cuban
кувейте	kuwait
кувейтской	kuwaiti
культуре	culture
культурного	cultural
культурных	cultural
кумар	kumar
кумулятивная	cumulative
кумулятивное	cumulative
кумулятивные	cumulative
купила	states
купли	purchase
купюр	notes
курдском	kurdish
курдскому	kurdish
кусочкам	pieces
кыргызская	kyrgyz
кыргызском	kyrgyz
кыргызстан	kyrgyzstan
кыргызстана	kyrgyzstan
кыргызстане	kyrgyzstan
кэмпбелла	campbell
кэрнсе	cairns
кэролин	carolyn
лабораторное	laboratory
лабораторной	laboratory
лабораторными	laboratory
лабораторных	laboratory
лабрадор	labrador
лагерях	camps
лагос	lagos
лагоса	lagos
лагосский	lagos
лакокрасочных	paint
ламбер	lambert
ламберт	lambert
лампочка	activated
ландшафту	landscape
ланкийских	lankan
ларсен	larsen
латвии	latvia
латвийская	latvian
латвийское	latvian
латвия	latvia
латинской	latin
латуни	brass
лебанон	lebanon
легитимности	legitimacy
легитимность	legitimacy
легитимные	legitimate
легкими	light
легковоспламеняющаяся	flammable
легочных	tokyo
ледовитый	arctic
лектор	lecturer
лекциях	lectures
ленча	lunch
леонардо	leonardo
леопольдо	leopoldo
лесбиянок	lesbian
лесничие	forest
лесовладельцами	owners
лесовозобновления	reforestation
лесовосстановительных	reforestation
лесовосстановления	reforestation
лесоматериалам	timber
лесоматериалами	timber
лесонасаждениями	planted
лесопользованию	forest
лесопользования	forest
лесото	lesotho
лета	summer
летательных	aircraft
летел	flying
летней	summer
летних	summer
летом	summer
летучих	volatile
либерией	liberia
либерийским	liberian
либерийских	liberian
либерийской	liberian
либерию	liberia
либерия	liberia
либертад	libertad
ливане	lebanon
ливаном	lebanon
ливанские	lebanese
ливанскими	lebanese
ливанских	lebanese
ливанского	lebanese
ливанскому	lebanese
ливийская	libyan
ливийской	libyan
ливневыми	rains
лиги	league
лигой	league
лигу	league
лидер	leader
лидера	leader
лидеров	leaders
лидса	leeds
лизинг	leasing
лизинга	leasing
лизинге	leasing
лимитирующим	constraint
линды	linda
лиссабонской	lisbon
листаж	constraints
листинга	listing
литва	lithuania
литве	lithuania
литературе	literature
литературного	literary
литературных	literary
литовский	lithuanian
литовскими	lithuanian
литовского	lithuanian
лихтенштейном	liechtenstein
лицензиата	licensee
лицензионными	licensing
лицензирование	licensing
лицензированных	licensed
лицензируемых	licensed
лицензируется	licensed
личный	personal
ллойд	lloyd
логичного	logical
лозанне	lausanne
лозаннского	lausanne
локации	location
лондон	london
лондонского	london
лондонской	london
лопеса	lópez
лоренса	lawrence
лоренсо	lorenzo
лосано	lozano
лосося	salmon
луандийского	luanda
луандском	luanda
луанду	luanda
луанды	luanda
луганская	lugano
луганской	lugano
луговых	grassland
луизе	louise
луизы	louise
луисе	luisa
лусаке	lusaka
лусакским	lusaka
лусакскими	lusaka
лусакского	lusaka
лусакское	lusaka
льеж	liège
любезная	kindly
любляна	ljubljana
людских	human
лютер	luther
маастрихте	maastricht
маастрихтского	maastricht
маастрихтском	maastricht
маврикием	mauritius
мавританию	mauritania
магистральными	routes
магистрату	magistrate
магистратурах	masters
мадагаскар	madagascar
мадагаскаре	madagascar
маджлис	majlis
мадре	madre
мадрид	madrid
мадриде	madrid
мадридские	madrid
мадридского	madrid
мадридской	madrid
маис	maize
маиса	maize
майер	mayer
майкл	michael
макгилла	mcgill
македонией	macedonia
маки	mackie
макинтайр	mcintyre
макроэкономических	macroeconomic
макроэкономического	macroeconomic
макроэкономической	macroeconomic
малазийской	malaysian
малайзии	malaysia
малайзия	malaysia
малика	malik
маликом	malik
маловероятность	unlikely
малоиспользуемых	lesser
маломасштабного	small-scale
маломасштабной	small-scale
маломасштабным	small-scale
маломерным	turning
малоплодородных	marginal
малополезными	ineffective
малоразмерные	satellites
малоформатную	pocket
малым	small
малых	small
мальдивские	maldives
малькольма	malcolm
мальта	malta
мальтийском	maltese
мальты	malta
малярией	malaria
малярии	malaria
манагуа	managua
мандат	mandate
мандатам	mandates
мандатным	mandated
мандела	mandela
манделе	mandela
манделой	mandela
манделу	mandela
манделы	mandela
манила	manila
маниле	manila
манилу	manila
манильской	manila
манильскую	manila
манитоба	manitoba
манифестантов	demonstrators
мануэль	manuel
мануэля	manuel
манфред	manfred
манхэттена	manhattan
маоистское	maoist
мапуто	maputo
мапутского	maputo
мапуту	maputo
маргинализованном	marginalized
маргинализованных	marginalized
марио	mario
маркетинг	marketing
маркетинга	marketing
маркетингом	marketing
маркировано	marked
маркус	markus
марокканские	moroccan
марокканских	moroccan
марокканской	moroccan
марта	march
марте	march
мартину	martin
мартовских	march
маршалла	marshall
маршалловы	marshall
маршалловых	marshall
массированной	massive
материнской	maternal
матрица	matrix
матрицу	matrix
мать	mother
маятниковых	outward
медельин	medellín
медельина	medellín
медных	copper
медсестрам	nurses
медь	copper
межамериканская	inter-american
межамериканский	inter-american
межамериканским	inter-american
межамериканской	inter-american
межамериканском	inter-american
международное	international
международной	international
международными	international
межкультурного	intercultural
межличностного	interpersonal
межобщинном	communities
межправительственного	intergovernmental
межправительственные	intergovernmental
межправительственным	intergovernmental
межправительственных	intergovernmental
мейсон	mason
мейсона	mason
меконга	mekong
мексика	mexico
мексиканские	mexican
мексиканских	mexican
мексике	mexico
мексику	mexico
мелкомасштабные	small-scale
мелкомасштабных	small-scale
меллу	mello
мельбурн	melbourne
мемориального	memorial
меньшинствах	minorities
меняющееся	changing
местными	local
местных	local
месяц	month
месяце	month
месяцы	months
месячных	monthly
металлические	metal
металлолома	scrap
металлолому	scrap
металлургию	steel
металлы	metals
метана	methane
метеорологическая	meteorological
метеорологических	meteorological
метеорологической	meteorological
метеорологию	meteorology
метеорология	meteorology
методологическая	methodological
методологической	methodological
методологическому	methodological
методологиях	methodologies
метрах	metres
мехди	mehdi
мехико	mexico
мехмет	mehmet
мехмета	mehmet
миграцией	migration
миграция	migration
мигрирующих	migratory
микро	micro
микроволновой	microwave
микронезии	micronesia
микронезия	micronesia
милиционеров	militiamen
миллз	mills
миллиарда	billion
миллионе	million
миллионы	millions
милях	miles
минералы	minerals
минимального	minimum
министр	minister
министра	minister
министром	minister
минск	minsk
минске	minsk
минут	minutes
минутами	minutes
миранда	miranda
мировоззрениями	attitudes
миротворцев	peacekeepers
миротворцы	peacekeepers
мифами	myths
мифы	myths
михаил	mikhail
михелем	michael
мичигана	michigan
мишеля	michel
младенческую	infant
млекопитающие	mammals
млрд	billion
многовековые	downward
многокультурного	multicultural
многокультурность	multiculturalism
многонациональными	multinational
многонациональных	multinational
многообещающие	promising
многостороннем	multilateral
многосторонние	multilateral
многосторонними	multilateral
многоцелевом	training
многоцелевому	multi
множественную	multiple
множественным	multiple
мобилизующую	catalytic
мобильном	mobile
мобильности	mobility
мобильность	mobility
мобильны	mobile
могущественный	powerful
могущественными	powerful
модельного	model
модифицировала	modified
модифицированных	modified
модулей	modules
мозамбик	mozambique
мозамбике	mozambique
мозамбиком	mozambique
мозамбику	mozambique
молдавия	moldova
молдавские	moldovan
молдавских	moldovan
молдову	moldova
молебнов	times
молния	storm
молодежные	youth
молодежными	youth
молодежных	youth
молодых	young
молочной	breast
монако	monaco
монбланом	blanc
монголии	mongolia
монд	monde
монография	monograph
монополистическими	pricing
монреале	montreal
монреаль	montreal
монреальский	montreal
монреальским	montreal
монреальского	montreal
монреальской	montreal
монреальскую	montreal
монровии	monrovia
монтевидео	montevideo
монтерейского	monterey
монтерейскому	monterey
монтеррее	monterrey
монтеррейе	monterrey
монтеррейский	monterrey
монтеррейского	monterrey
монтеррейской	monterrey
монтеррейском	monterrey
монтсеррат	montserrat
монтсеррата	montserrat
монтсерратом	montserrat
моральную	moral
морган	morgan
моргана	morgan
морено	moreno
москве	moscow
московский	moscow
московского	moscow
мостика	bridge
мосуле	mosul
мотивируемыми	motivated
мотивируемых	motivated
моура	moura
мохамед	mohamed
мубарака	mubarak
мубараком	mubarak
мугабе	mugabe
муж	husband
музее	museum
музей	museum
музея	museum
музыки	music
музыку	music
муниципалитет	municipality
муниципалитетам	municipalities
муниципалитетами	municipalities
муниципалитетах	municipalities
муниципалитете	municipality
муниципалитеты	municipalities
муниципальном	municipal
муниципиями	municipalities
муньос	muñoz
мусорной	landfill
мусорные	landfills
мусульманах	muslims
мусульманином	muslim
мусульманским	muslim
мусульманских	muslim
мфр	scenario
мьянме	myanmar
мьянмы	myanmar
мэннинга	manning
мэра	mayor
мэрией	mayor
мэриленд	maryland
мэров	mayors
мюллера	müller
мюллером	müller
мятежная	rebel
набирающих	literature
наблюдаемому	observed
наблюдатели	observers
наблюдатель	observer
наблюдательские	observation
набравшему	enforcing
набранное	gained
набранную	momentum
навязанных	imposed
навязывали	impose
нагнетании	fostering
награбленного	looted
нагревательных	heating
надругательства	abuse
наемнического	mercenary
наемнической	mercenary
назначаемую	appointed
назревающие	emerging
наименее	least
наинизшем	lowest
наинизший	lowest
найроби	nairobi
найробийской	nairobi
найт	knight
накоплениях	carbon
налагающей	places
намибии	namibia
намибийскими	namibian
намибийских	namibian
намибию	namibia
нанимателя	employer
нападал	attacked
наполнения	filling
направляющийся	going
нарисовал	painted
наркотикам	drugs
наркотическим	narcotic
народ	people
народа	people
народонаселению	population
народонаселения	population
населенным	settlements
насером	nasser
насилии	violence
насиловали	raped
наследного	crown
наследный	crown
наследовании	inheritance
нассер	nasser
настаивающего	weeks
настрою	another
наступательных	offensive
наталкивалось	always
наука	science
науке	science
науру	nauru
научил	taught
научили	taught
нафта	nafta
находящим	supplied
национальностями	nationalities
национальностях	nationalities
национальные	national
национальными	national
национальных	national
начальству	senior
начисленные	assessed
неапольских	naples
небезразличны	aspirations
небеременных	pregnant
невеш	neves
невзорвавшихся	unexploded
невиновному	labor
невисе	nevis
невнимания	neglect
невозмещение	liable
невыгодна	economical
невыясненной	unresolved
негеве	negev
негласным	destined
негритянской	black
недавних	recent
недатированный	undated
недобровольного	involuntary
недобровольной	involuntary
недобровольному	involuntary
недобровольным	involuntary
недобровольными	involuntary
недобровольных	involuntary
недобросовестной	unfair
недолгую	young
неевропейской	europe
независимого	independent
независимой	independent
независимости	independence
независимых	independent
незамедлительным	urgent
незапрещенной	prohibited
незарезервированные	balances
неизбирательная	mobilization
неизбирательное	indiscriminate
нейтрального	neutral
нейтральной	neutral
нейтральности	neutrality
нейтральностью	neutrality
неконституционного	unconstitutional
неконституционным	unconstitutional
неконституционных	unconstitutional
нельсоном	nelson
нельсону	nelson
немедленные	immediate
немецком	german
необработанном	unfinished
необработанными	rough
необработанных	rough
необратимом	irreversible
необратимый	irreversible
неодинаковому	unequal
неоплаченным	unpaid
неопределенностями	uncertainties
неопубликованный	unpublished
неорганическими	inorganic
неосторожностью	negligence
неосязаемых	intangible
непал	nepal
непали	nepali
непальские	nepalese
непальским	nepalese
непальскими	nepalese
непатентованные	generic
непатентованных	generic
неподдающихся	impossible
непоправимой	irreversible
непосильного	unsustainable
неправительственные	non-governmental
неправительственными	non-governmental
неправомерны	illegal
неправомочной	incorrect
неприсоединения	non-aligned
неприсоединившихся	non-aligned
неприспособленности	adjusted
неприятностями	especially
непроизводительный	consumption
непропорционального	disproportionate
непропорциональное	disproportionate
непропорциональным	disproportionate
непрямого	indirect
непрямой	indirect
неразберихе	confusion
неразборчивое	indiscriminate
неразорвавшиеся	unexploded
неразрешимую	impossible
нераскрытым	unresolved
нерегулярную	occasional
нерезидента	non-resident
несовместимые	incompatible
несопровождаемые	unaccompanied
несоразмерное	disproportionate
несостоятельности	insolvency
нестратегической	missile
нетерпимости	intolerance
нетерпимость	intolerance
нетранспарентным	transparent
неуважении	contempt
неуведомления	failure
неудачах	failures
неукомплектованность	identifying
неустойчивому	unsustainable
неучтенный	segment
неформальном	informal
нецелесообразностью	economical
неэкономичными	radio
нигер	niger
нигера	niger
нигере	niger
нигерией	nigeria
нигерийская	nigerian
нигерийскими	nigerian
нигерию	nigeria
нигерия	nigeria
нигером	niger
нигеру	niger
нидерландов	netherlands
нието	nieto
нищета	poverty
нищетой	poverty
нищету	poverty
нищеты	poverty
нобелевской	nobel
новак	nowak
новаторские	innovative
новаторских	innovative
новобранцы	recruits
номерного	plate
норвегию	norway
норвежские	norwegian
норвежским	norwegian
норвежского	norwegian
норвежском	norwegian
норман	norman
норта	oliver
норьега	noriega
ноябрь	november
ноября	november
нэнси	nancy
оахака	oaxaca
обвинителей	prosecutors
обвинителем	prosecutor
обдуманных	smart
обедненного	depleted
обезвреженных	cleared
обезлесение	deforestation
обезлесении	deforestation
обезлесению	deforestation
обезлесения	deforestation
обеспеченного	secured
обеспеченный	secured
обеспеченных	secured
обеспечительной	measure
обеспокоен	concerned
обжаловав	filing
облавах	raids
облесенных	forested
обмениваемых	shared
обменивающиеся	powerful
обменивающихся	share
обобщали	compile
обогрева	heating
обозреваемых	reviewed
обоснованны	justified
обособлению	isolation
обрабатываемого	cargo
обремененное	collateral
обрисовав	highlighting
обсудил	discussed
обсуждавшемуся	subject
обусловившее	substantial
обучаете	educate
обучена	trained
общеевропейскими	pan-european
общеевропейских	pan-european
общеприемлемого	acceptable
общеприменимого	approach
общеприменимыми	applicable
общеродовой	generic
обществами	societies
общественной	public
объявляющую	declaring
обыскали	searched
обязательность	bound
обязующей	literature
овощам	vegetables
огненная	tierra
оговорок	reservations
ограждается	marked
огражденных	getting
ограничиваемая	liability
ограничивающему	limiting
ограничительной	restrictive
ограничительный	restrictive
одиннадцатого	eleventh
одиннадцатые	eleventh
однополым	same-sex
одобряемые	commits
одобрялась	approved
ожиданий	expectations
ожидающими	awaiting
озаглавлен	entitled
озаглавленной	entitled
озаглавленную	entitled
озеленения	greening
озон	ozone
озона	ozone
океанографии	oceanography
океанографическая	oceanographic
океанографической	oceanographic
океанографическом	oceanography
океанографическую	oceanographic
океанография	oceanography
океанология	political
оккупаций	occupation
оккупированной	occupied
оккупируемых	occupied
окланде	auckland
окленде	auckland
окно	window
окончательный	final
окружной	district
окружном	district
оксидам	nitrogen
оксидов	oxides
оксиды	oxides
октябрь	october
октября	october
окупаться	market
оливковых	olive
олимпийского	olympic
олимпийскому	olympic
онтарио	ontario
оператора	operator
операторам	operators
оператору	operator
опечатали	sealed
опечатанных	sealed
опечатаны	sealed
опиума	opium
опиумом	opium
опломбированы	sealed
ополченские	militias
ополченческих	militia
ополченческой	residing
оппозиционных	opposition
оправдывались	justified
определений	definitions
определенности	certainty
определенность	certainty
опробованной	proven
опросников	questionnaires
опубликованное	issued
опустынивание	desertification
опустыниванием	desertification
опустынивании	desertification
опустынивания	desertification
опущенном	closed
опциона	option
ораторов	speakers
ораторы	speakers
организмам	organisms
организмами	organisms
организмах	organisms
организованной	organized
организуемому	taught
организующими	organizing
органических	organic
ордерами	warrants
ориентационной	orientation
орландо	orlando
оросительных	irrigation
орсси	oasis
ортиса	ortiz
орхусе	aarhus
осадках	precipitation
осадой	siege
осаду	siege
осветив	highlighting
освободившейся	secret
освободительной	liberation
освященные	title
оскар	oscar
осколок	pieces
оскорбляющее	insulting
османа	osman
османской	ottoman
осматривают	detained
основателям	businesses
осознан	given
оспаривающее	filed
островные	island
островным	island
островных	island
осудила	condemned
осуждаем	condemn
осуждённым	convicted
осуществляющимся	existing
отборочной	selection
отвергаем	reject
отвергнутой	rejected
ответившим	responded
ответственных	responsible
отгрузочное	shipping
отгрузочному	shipping
отдаления	distance
отец	father
отечественное	domestic
отечественными	domestic
отечественных	domestic
откажут	channel
отклоненном	state
отклоненным	rejected
отклоняла	reject
откровений	messages
отлученных	excluded
отм	removing
отмечая	noting
отобрании	removal
отобранное	chosen
отобранными	selected
отопительных	heating
отпуск	leave
отпустила	released
отравлении	poisoning
отравлению	poisoning
отравлениях	poisoning
отрезает	merchandise
отрицающая	obligations
отрочества	adolescence
отстояние	sediment
оттава	ottawa
оттаве	ottawa
оттавской	ottawa
оттавскую	ottawa
отучиться	struggle
отфильтрованный	sludge
отчетах	records
отчётность	reporting
отчужденностью	exclusion
офертами	offers
офертой	offer
оффшорной	offshore
оффшорные	offshore
оффшорных	offshore
офшорная	offshore
офшорной	offshore
офшорному	offshore
офшорные	offshore
офшорным	offshore
охватываемыми	covered
охлаждающего	cooling
охота	hunting
охоты	hunting
охраняемыми	protected
пабло	pablo
падилья	padilla
пакетный	package
пакету	package
пакистан	pakistan
пакистанские	pakistani
пактах	covenants
пакте	covenant
пакты	covenants
паласиос	palacios
палата	chamber
палестинского	palestinian
палестинцах	palestinians
палестинцы	palestinians
памела	pamela
панаме	panama
панамой	panama
панъевропейского	pan-european
панъевропейском	pan-european
паоло	paolo
папуа	papua
парагваем	paraguay
парагвай	paraguay
парагвая	paraguay
парадигмам	paradigms
парадигмах	paradigms
парадигмы	paradigm
параметром	parameter
париж	paris
париже	paris
парижем	brussels
парижские	paris
парижскими	paris
парижских	paris
парижской	paris
паритете	parity
паркер	parker
парламент	parliament
парламентам	parliaments
парламентами	parliaments
парламентариев	parliamentarians
парламентарии	parliamentarians
парламентариями	parliamentarians
парламентариях	ministers
парламентом	parliament
парламентской	parliamentary
парламенты	parliaments
паромное	ferry
паромные	ferry
паромных	ferry
пароходств	shipping
парсонс	parsons
партизанских	guerrilla
партнера	partner
партнерами	partners
партнере	partner
партнером	partner
партнеры	partners
паскалем	executive
паскаля	pascal
паспорт	passport
пассажи	expressions
пассивов	liabilities
пассивы	liabilities
пасторской	pastoral
пастыря	shepherd
патент	patent
патентными	patent
патентовладельца	patent
патриархального	patriarchal
патриархальными	patriarchal
патрик	patrick
патрика	patrick
патриот	hills
паттерсон	patterson
паулы	paula
пашине	lymph
пая	units
педагогическому	profession
педро	pedro
педру	pedro
пекин	beijing
пекинскую	beijing
пелагический	pelagic
пелагического	pelagic
пелагическому	pelagic
пенсионного	pension
пеплом	hours
первого	first
переведенном	interpreter
перевернутой	behind
переводимого	sales
перевозившего	transporting
перевозчика	carrier
перевозчиком	carrier
передало	transferred
передающую	transferring
передвижения	movement
пережиткам	remnants
пережитки	remnants
пережитков	remnants
перезаселения	schemes
перейру	pereira
перейры	pereira
перекрывающихся	overlapping
перемену	change
переместятся	elsewhere
перемешиваются	mixed
перемещенным	displaced
перемещенных	displaced
переносилась	postponed
переносимое	transferred
переписи	census
перепиской	correspondence
переполненности	overcrowding
переправляться	cross
перепрофилированием	conversion
перепутье	crossroads
переселенцах	displaced
пересматривал	revised
пересчитано	converted
переходное	transitional
перечни	lists
периодический	periodic
перл	pearl
пернамбуко	pernambuco
пернамбуку	pernambuco
персональным	personal
персоной	persona
пестицидам	pesticides
пестицидном	pesticide
пестицидных	pesticide
пестициды	pesticides
петер	peter
петерсен	petersen
пешеходного	walking
пётр	piotr
пилар	pilar
пилотных	pilot
пиночет	pinochet
пиратства	piracy
пиратстве	piracy
пиратство	piracy
пиратством	piracy
пиратству	piracy
пирсона	pearson
писарро	pizarro
писать	write
письме	letter
письменные	written
письмо	letter
питающими	sustained
питера	peter
питкэрна	pitcairn
плавающими	flying
плавильном	smelter
плавучими	marked
плазмы	plasma
плакатом	criticized
планировались	planned
планирование	planning
плановиков	planners
планомерные	structured
пластическими	plastic
пластических	plastic
платежеспособных	solvent
платности	tariffs
платформ	platforms
платформах	platforms
платформе	platform
платформой	platform
племенами	tribes
пленарном	plenary
плодотворные	fruitful
плюрализм	pluralism
плюрализме	pluralism
поблагодарил	thanked
поблагодарила	thanked
побуждались	encouraged
поверенного	chargé
поверило	inspire
повинного	innocent
повинных	innocent
повреждена	damaged
повреждены	damaged
повстанческим	rebel
повтором	repeated
повышательное	pressures
поглотителями	sinks
поглощениях	acquisitions
поговорили	person
погодных	weather
пограничного	border
пограничному	border
погрузки	loading
подаваемый	examples
подарках	gifts
подветренных	leeward
подголовниками	restraints
подголовников	restraints
подготовившего	generates
подготовительной	preparatory
подготовительный	preparatory
поддающемся	verifiable
подкомитет	subcommittee
подкомитета	subcommittee
подкомитету	subcommittee
подкрепляющее	reproductive
подкупить	bribe
подкупом	bribery
подлинный	original
подмосковье	moscow
подневольному	forced
поднимаемые	raised
поднятые	raised
подопытного	experimental
подотчетного	accountable
подотчетности	accountability
подотчетность	accountability
подотчетностью	accountability
подотчетным	accountable
подписали	signed
подписанное	signed
подписываемого	sealed
подпись	signed
подписях	signatures
подпольных	clandestine
подполья	underground
подпочвенные	aggregate
подразумеваемом	implicit
подробный	detailed
подсудно	judge
подтверждаемом	injustice
подчеркивающее	stressing
подчиняющаяся	attached
пожалеть	effort
позднем	later
позитивную	positive
позитивные	positive
поименованный	named
поименованным	named
поимку	apprehension
поисковым	choice
показавший	shown
поколений	generations
покровительствуемых	protected
покупательную	purchasing
покупками	shopping
полевых	field
полетную	flight
ползучий	clover
поликультурных	multicultural
политзаключенные	netherlands
политически	politically
политического	political
политической	political
полиции	police
полковник	colonel
полувоенная	paramilitary
полувоенной	paramilitary
полузасушливых	semi-arid
получающем	receives
полушарием	hemisphere
полыхают	there
польского	polish
польша	poland
польше	poland
помеченных	marked
помощник	assistant
помощнику	assistant
понедельник	monday
пониманием	understanding
понравилось	enjoyed
понятыми	understood
пополнила	updated
порнографией	pornography
порнографии	pornography
порогового	threshold
порождении	prevalent
портера	porter
португалией	portugal
португалии	portugal
португалия	portugal
португальские	portuguese
португальский	portuguese
португальских	portuguese
португальского	portuguese
португальской	portuguese
портфельные	portfolio
портфельных	portfolio
портфеля	portfolio
посвятивших	dedicated
посвящаемое	available
посевного	planting
поселяться	settling
посетил	visited
посетила	visited
посещениями	visits
посла	ambassador
послание	message
послевузовского	postgraduate
послевузовское	studies
послом	ambassador
послужившая	their
посольство	embassy
посольством	embassy
посольству	embassy
постановила	decided
поступающему	queen
потенциальной	potential
потенциальные	potential
потепление	warming
потерпевшее	injured
потерявший	unconscious
потрачен	spent
потраченный	spent
потребителе	end-user
потребительных	indexes
похищенном	stolen
почках	kidney
почтенной	honourable
пояснила	explained
правдивое	telling
правдоподобные	plausible
правительствами	governments
правительство	government
правительством	government
правовым	legal
правозащитниками	defenders
правозащитниках	defenders
правозащитники	defenders
правообладателей	holders
правообладатель	holder
правоотношением	relationship
правопреемстве	succession
православной	orthodox
православные	orthodox
правосубъектность	personality
правосудии	justice
правосудия	justice
праге	prague
прадо	prado
прадхан	pradhan
пражского	prague
праздновался	observed
практик	practices
практиками	practitioners
практикумов	workshops
практичных	practical
преамбула	preamble
преамбуле	preamble
превентивные	preventive
превосходительству	excellency
предварительной	provisional
предлагаемой	proposed
предлагаемом	proposed
предложившее	offering
предотвращаться	prevented
предписывающая	mining
предположительную	mining
предпочитаемой	preferred
предпринявшего	pursuing
предсказуема	realistic
представитель	representative
представительском	trust
представителя	representative
предупреждал	warned
предъявит	produces
преемник	successor
преемнику	successor
преемственности	continuity
преемственность	continuity
презентаций	presentations
преимущественными	superior
пренебрегали	neglected
преобразовывают	transforming
преподносить	deliver
препроводив	giving
прервав	terminated
прессой	press
прессы	press
претории	pretoria
преторийского	pretoria
преторию	pretoria
претория	pretoria
преференциального	preferential
преференциальные	preferential
преференциальных	preferential
преференционного	preferential
прецизионность	precision
прибалтийских	baltic
приборном	vehicle
прибрежной	coastal
прибрежные	coastal
прибрежных	coastal
приватизацией	privatization
приватизация	privatization
приватной	talking
приверженность	commitment
приветствовал	welcomed
приветствовала	welcomed
приветствуем	welcome
приветствуя	welcoming
привилегий	privileges
привилегиям	privileges
привилегиями	privileges
привлечете	alert
приглашены	invited
приграничном	border
придавшего	country
приезжие	arriving
прикоснулась	contact
прилагающими	engaged
приличным	decent
приложение	annex
приложении	annex
применимом	applicable
применимость	applicability
применимым	applicable
применяющие	applying
примечательную	remarkable
примирением	reconciliation
примирения	reconciliation
принстонского	princeton
принудит	force
принудительный	forced
принцем	prince
принятую	adopted
приобретениям	acquisitions
приобретенная	acquired
приоритетами	priorities
приоритетах	priorities
приостанавливается	suspended
приостановленной	suspended
приращений	products
природным	natural
природными	natural
природных	natural
приросшими	bloom
присваиваемого	attributable
приспособленности	adapted
приспособленную	supports
присуждаться	awarded
присутствуя	attending
притеснениях	harassment
притесняемым	targeted
притесняемыми	targeted
прифронтовыми	frontline
причиняющая	undermining
причисляли	claimed
проактивного	proactive
проанализированная	analysed
пробам	samples
пробации	probation
пробоотборника	probe
провалившейся	failed
проверяемое	arranged
проверяй	verify
провинциальном	provincial
провинциальными	provincial
провинциальных	provincial
проводившему	cabinet
провозгласившая	declared
прогнозируемому	projected
программе	programme
программирования	programming
прогрессивного	progressive
прогрессивное	progressive
прогрессивному	progressive
продвинутом	advanced
продемонстрированных	demonstrated
продлевал	extended
продлено	extended
продольной	longitudinal
продольные	longitudinal
продуктивного	productive
продуктивной	productive
продуктивную	productive
продуктивные	productive
продуктивных	productive
проездных	travel
проекте	draft
прожившие	lived
проживших	lived
прозрачен	transparent
прозрачности	transparency
прозрачных	transparent
проигравший	action
проигравшую	losing
производивший	facility
производительной	productive
производительности	productivity
производительную	productive
производительные	productive
производительных	productive
произвольные	arbitrary
произвольными	arbitrary
произвольных	arbitrary
проинструктировало	instructed
проинформирована	informed
проистекающим	stemming
прокуроров	prosecutors
пролетев	flying
проливам	straits
промаркированы	marked
промежуточный	interim
промеров	measurements
промышленного	industrial
промышленному	industrial
пропавшим	missing
проприетарные	proprietary
пропускаться	admitted
пропуску	passage
проработавшим	leave
просвещать	educate
просила	requested
прослеживающуюся	tendency
простейшем	elementary
пространственного	spatial
пространственном	spatial
пространственных	spatial
просчетах	delays
просьбе	request
протестантских	protestant
противоборствующей	adverse
противовесов	balances
противоминным	action
противоположном	opposite
противоречивому	controversial
протокол	protocol
протокола	protocol
протоколу	protocol
протокольная	protocol
профессор	professor
профсоюзами	unions
профсоюзы	unions
процедурный	procedural
процедурным	procedural
процедурных	procedural
проявившим	innovative
проявленных	demonstrated
прояснила	clarified
пружинными	brakes
прямые	direct
прямых	direct
психический	mental
психического	mental
психологическая	psychological
психосоциальные	psychosocial
психотерапевтической	counselling
публикаций	publications
публично	publicly
публичного	public
публичном	public
публичности	publicity
пулю	bullet
пункте	paragraph
пустыней	desert
пустынном	desert
пустынь	deserts
путали	confused
путаницы	confusion
путевых	travel
пущена	domination
пуэбла	puebla
пуэбле	puebla
пуэрториканских	rican
пшеницы	wheat
пшеничную	wheat
пытках	torture
пытки	torture
пытку	torture
пьера	pierre
пэтриот	patriot
пятнадцатой	fifteenth
пятнадцатом	fifteenth
пятнадцатый	fifteenth
пятнице	friday
пятницу	friday
пятницы	friday
рабат	rabat
рабате	rabat
рабатский	rabat
рабатского	rabat
рабатской	rabat
рабатскую	rabat
работодателей	employers
работодателем	employer
работодатели	employers
работодателя	employer
работодателям	employers
работорговли	slave
работорговля	slave
рабочей	working
рабство	slavery
равносильных	amounting
радарные	radar
радарных	radar
радаров	radar
радикальной	radical
радиоактивные	radioactive
радиоактивными	radioactive
радиоастрономии	astronomy
радиологические	radiological
радиологических	radiological
радиологического	radiological
радиологической	radiological
радиолокатора	radar
радиоматериалов	material
радиооборудование	radio
радостями	adolescence
разбою	robbery
разбоя	robbery
разбросанность	dispersion
разбросанным	dispersed
разведорганами	intelligence
разведорганов	intelligence
разведочных	exploration
разведывательными	intelligence
развернулся	turned
развернутому	detailed
развивающимся	developing
развитые	developed
развитым	developed
развитых	developed
развратными	abuse
разгара	height
разграблялись	looted
разделяем	share
разлучаться	justified
разлучение	separation
разлученные	separated
разлученными	separated
разлученных	separated
разлучены	separated
разновидностей	varieties
разнообразии	diversity
разоблачая	denounce
разоружение	disarmament
разоружением	disarmament
разоружении	disarmament
разоружению	disarmament
разоружения	disarmament
разрабатывавшихся	negotiated
разрегулирование	deregulation
разрезания	cutting
разрешившего	authorized
разрешительные	authorization
разрешительным	permission
разряды	level
разумеющееся	granted
разумные	reasonable
разъединением	disengagement
разъедутся	disperse
разъясненным	explained
раймонд	raymond
райт	wright
райтс	watch
ракетам	missiles
раковую	cancer
ралф	ralph
ральф	ralph
ральфа	ralph
рамадана	ramadan
рамаллах	ramallah
рамаллаха	ramallah
рамаллахом	ramallah
рамаллу	ramallah
рамаллы	ramallah
рамеш	ramesh
рамеша	ramesh
рамиреса	ramírez
рамона	ramón
рамос	ramos
рамочного	framework
рамочной	framework
рамсарская	ramsar
рамсарской	ramsar
расизма	racism
расизме	racism
расистская	racist
расистски	racist
расистских	racist
расистской	racist
раскрепощения	emancipation
расовая	racial
распискам	existing
расплывчатыми	vague
расправе	massacre
распределители	centres
распутье	crossroads
распыленный	identity
расселл	russell
расследовались	investigated
рассмотрев	having
расстановкой	placement
растворенные	dissolved
растворенный	dissolved
растворенных	dissolved
растворители	solvents
растительность	vegetation
расторгли	denounced
растянулся	spread
расчищаются	cleared
расчищено	cleared
расчищены	cleared
ратифицировала	ratified
ратифицировали	ratified
ратифицировало	ratified
ратифицированному	german
ратифицированными	ratified
ратифицировать	ratify
раундов	rounds
рахман	rahman
реабилитацией	rehabilitation
реализационным	resolution
реалистические	realistic
реалистическими	realistic
реалистического	realistic
реалистической	realistic
реалистичного	realistic
реалистичной	realistic
реалистичную	realistic
реалистичны	realistic
реалистичные	realistic
реалистичный	realistic
реальность	reality
реальностях	realities
ребенка	child
реверсивный	auction
ревизией	audit
ревизора	auditor
ревизорского	audit
революцией	revolution
революции	revolution
революционный	revolutionary
революционным	revolutionary
революция	revolution
регионального	regional
региональном	regional
региональными	regional
региональных	regional
регионами	regions
регионе	region
регистра	register
регламентационные	regulatory
регламентировало	measures
регламентированными	regulated
регулировавших	governed
регулярный	regular
регулятивную	plain
регулятивный	regulatory
регулятивными	regulatory
регулятивных	regulatory
редакционной	drafting
редди	reddy
режимным	sensitive
режимов	regimes
режимы	regimes
режиссера	politically
резервационных	reserve
резиновые	rubber
резиновыми	rubber
резины	rubber
резистентностью	resistance
резолюций	resolutions
резолюцию	resolution
резолюция	resolution
резолюциям	resolutions
резолюциями	resolutions
результирующих	render
резюмированию	summarized
рейеса	reyes
рейесом	reyes
рейесу	reyes
реймонда	raymond
рейну	rhine
реклассифицированные	reclassified
рекогносцировочные	reconnaissance
рекомендацию	recommendation
рекомендовала	recommended
ректором	rector
рекуперируемых	recovered
религией	religion
религиозного	religious
религиозными	religious
религиозных	religious
религиями	religions
рельефного	visible
рентабельных	viable
репатриаций	repatriation
репортерам	reporters
репрессалии	reprisals
репрессалиях	reprisals
репрессивное	repressive
репродуктивного	reproductive
репродуктивное	reproductive
репродуктивным	reproductive
репродуктивных	reproductive
респондентами	respondents
респонденты	respondents
республика	republic
республиканской	republican
республике	republic
республики	republic
реституцией	restitution
реституции	restitution
реституцию	restitution
ресторана	restaurant
ресторанам	licensed
ресурсы	resources
референдума	referendum
реформаторского	severe
рецептах	prescriptions
рециркулируемые	recycled
ривера	rivera
рикардо	ricardo
рисковые	ratings
рисунку	figure
риттер	ritter
рифы	reefs
ричард	richard
ричардсона	richardson
ркт	rocket
роберт	robert
роберта	robert
роберто	roberto
робертс	roberts
робертсон	robertson
робин	robin
робинсон	robinson
рогатым	livestock
родольфо	rodolfo
родоразрешения	delivery
родригиш	rodrigues
рокфеллера	rockefeller
ролан	roland
ромеро	romero
рональд	ronald
российской	russian
ротой	engineering
роттердаме	rotterdam
роттердамская	rotterdam
роттердамской	rotterdam
роттердамскую	rotterdam
рохас	rojas
рохаса	rojas
роя	schneider
ртути	mercury
ртутные	mercury
руанда	rwanda
руандийскими	rwandan
рудных	minerals
румынии	romania
румынских	romanian
румынского	romanian
руссо	rousseau
рухнут	collapse
ручьев	streams
ручьи	streams
рыбохозяйственного	fisheries
рыбохозяйственные	fisheries
рынками	markets
сабах	sabah
сабаха	sabah
сабер	saber
сагпс	great
саддам	saddam
саддама	saddam
садоводческих	garden
саймон	simon
сайтах	sites
сайты	sites
сакс	sachs
салазар	salazar
салаха	salah
салем	salem
салерно	salerno
салех	saleh
салеха	saleh
салима	salim
салимом	salim
салман	salman
сальвадоре	salvador
сальман	salman
самовосстановлению	resilience
самообеспечиваемости	self-reliance
самоопределение	self-determination
самоопределении	self-determination
самоопределению	self-determination
самоопределения	self-determination
самоорганизоваться	organize
самопомощи	self-help
самопомощь	self-help
самоубийствах	suicide
самуэль	samuel
самюэль	samuel
сандерс	sanders
сандерса	sanders
сандра	sandra
санитарию	sanitation
санкций	sanctions
санкционированы	authorized
сантандер	santander
сантос	santos
сантуш	santos
сантуша	santos
сантушу	santos
сантьяго	santiago
санчеса	sánchez
сараево	sarajevo
сасаки	sasaki
саттон	sutton
саудовская	saudi
саудовскому	saudi
сахар	sugar
сахаре	sahara
сахарной	sugar
сахарой	sahara
сбалансированном	balanced
сбалансированности	balance
сбалансированные	balanced
сбалансированный	balanced
сберегательная	savings
сберегающих	conservation
сбили	shooting
сбитого	aircraft
сбрасываемого	discharged
сбытовую	sales
сбытовым	agent
свазиленду	swaziland
сведущих	education
сверке	reconciliation
сверкой	reconciliation
светлана	svetlana
светосилы	intensity
свидетелю	witness
свидетеля	witness
свободам	freedoms
своевременного	timely
своевременной	timely
своевременных	timely
связную	coherent
связующими	connecting
сгружать	download
сгруппированный	grouped
сдаваемыми	deposited
сева	planting
североатлантического	atlantic
севооборота	rotation
сегрегированные	segregated
седьмом	seventh
сезонного	seasonal
сезонной	seasonal
сезонные	seasonal
секретариат	secretariat
секретариата	secretariat
секретариатом	secretariat
секретную	sensitive
сексуальное	sexual
сексуальной	sexual
сексуальном	sexual
сексуальностью	sexuality
сексуальную	sexual
сект	sects
сектором	sector
секунд	seconds
секциями	sections
селам	towns
селективных	selective
сельхозкультур	crops
сельхозпродукцией	agricultural
сельхозпроизводители	farmers
селян	incomes
семейной	family
семь	seven
семьям	families
сенатор	senator
сенатором	senator
сенегал	senegal
сентябрь	september
сентябрьских	september
сентябрю	september
сентября	september
сербией	serbia
сербии	serbia
сербия	serbia
серверной	server
серебряные	silver
серебряный	silver
сертификаты	certificates
сертификации	certification
сертификаций	schemes
сертифицированных	certified
серу	sulphur
серы	sulphur
серьёзную	serious
сессия	session
сессиях	sessions
сестринское	nursing
сеул	seoul
сеула	seoul
сеуле	seoul
сибирь	siberia
сигареты	cigarettes
сигло	siglo
сиднее	sydney
сильвен	sylvain
сильвиа	sylvia
симба	simba
сименс	siemens
симпозиум	symposium
симпозиума	symposium
симпозиумам	world
симпсон	simpson
симпсоном	simpson
сингапура	singapore
сингапуре	singapore
сингапурские	singapore
сингх	singh
сингху	singh
синдиката	syndicate
синклером	sinclair
синтезированной	aperture
сирией	syria
сирийская	syrian
сирийской	syrian
сирия	syria
сироты	orphans
систематические	systematic
систематическое	systematic
систематичный	systematic
ситес	cites
ситуативного	situational
сиэтл	seattle
сиэтле	seattle
складывавшейся	developed
скобки	brackets
скована	severely
скоординированного	coordinated
скоординированное	coordinated
скоординированной	coordinated
скоординированном	coordinated
скоординированные	coordinated
скоординированных	coordinated
скорректированному	adjusted
скотленд	baroness
скрининг	screening
скрывающееся	fugitive
слаболесистых	cover
слагаются	consist
сладкий	sweet
сладкого	sweet
следователи	investigators
слеп	blind
слепой	blind
слепым	blind
слепых	blind
сливающихся	merging
словакией	slovakia
словакии	slovakia
словакию	slovakia
словацкая	slovak
словацкими	slovak
словацкой	slovak
словении	slovenia
словению	slovenia
слоёв	segments
случающихся	occurrences
слышали	heard
слышно	heard
смесей	mixtures
смешанного	mixed
смиримся	accept
смита	smith
снабжало	chiefs
снабжался	received
снижающегося	declining
снимаемых	removed
снимается	withdrawn
снимками	images
сноске	footnote
сноску	footnote
сносок	footnotes
снят	withdrawn
собирающие	collect
собирающим	collecting
собор	cathedral
собранного	collected
собратьями	fellow
собственникам	owners
собственнике	owner
советника	adviser
советские	soviet
советский	soviet
советских	soviet
советскому	soviet
согражданами	fellow
содействовавшим	facilitated
содержимом	contents
сожжению	burning
сожженных	burned
созвана	convened
созванной	convened
созванных	convened
созвано	convened
созидательное	creative
созидательных	beneficial
сознавал	factual
созыв	convening
солдатом	soldier
солидарности	solidarity
солидарность	solidarity
солидарными	solidarity
солнечной	solar
соломоновых	solomon
сомали	somalia
сомалийские	somali
сомалийскими	somali
сомалийских	somali
сомалийском	somali
сомалийскому	somali
сообщества	community
сообщество	community
сопоставимой	comparable
сопоставительной	comparative
сопоставительными	comparative
сопровождаться	accompanied
сопровождающая	accompanying
сопротивлением	resistance
соразмерность	proportionality
сориентировано	oriented
соседние	neighbouring
соседних	neighbouring
соседями	neighbours
сослаться	refer
сосредоточенным	provinces
сосуществованием	coexistence
сосьете	société
сотней	hundred
сотни	hundreds
сотням	hundreds
соучастия	complicity
софии	sofia
софийской	sofia
сохранившимся	existing
сохраняемого	retained
социалистической	socialist
социальной	social
социальные	social
социальный	social
социальным	social
социальных	social
сочетающиеся	adjusted
сочинений	essay
союзная	federal
союзом	union
специализированные	specialized
специализированных	specialized
спецификаций	specifications
спецификацию	specification
специфичным	advise
спинами	behind
спора	dispute
справочный	background
спрятанного	hidden
спуску	launching
спутниковой	satellite
сравнительные	comparative
сравнительных	comparative
средиземноморскими	mediterranean
средиземноморских	mediterranean
средиземноморья	mediterranean
сспч	presidency
стабилен	stable
стабильной	stable
стабильности	stability
стабильность	stability
стадионе	stadium
стакана	glass
стамбул	istanbul
стамбуле	istanbul
стамбульский	istanbul
стамбульского	istanbul
стамбульскую	istanbul
стандард	standard
стандарт	standard
стандарта	standard
стандартизированной	standardized
стандартизированными	standardized
стандартизованной	standardized
стандартизованы	standardized
стандартные	standard
стандарты	standards
станционных	terminal
старательным	reasonable
старающиеся	trying
старейшин	elders
старейшинам	elders
старейшинами	elders
старения	ageing
старинным	tours
старо	itself
стартом	start
статистической	statistical
статические	static
статичной	static
статичный	static
статут	statute
статутами	statutes
статутах	statutes
статутом	statute
статье	article
статьями	articles
статьях	articles
створок	system
стелла	stella
стенографических	verbatim
стива	steve
стоимостная	valuation
стойкие	persistent
стойким	persistent
стойкими	persistent
стокгольм	stockholm
стокгольмская	stockholm
стокгольмского	stockholm
стокгольмской	stockholm
стокгольмскую	stockholm
столах	tables
столиц	capitals
столице	capital
столов	tables
стоматологических	dental
страда	strada
страданию	suffering
страна	country
страниц	pages
страницами	pages
страновом	country
страсбургском	strasbourg
стратегия	strategy
страхование	insurance
страховщик	insurer
страховщикам	insurers
страховщиками	insurers
страховщику	insurer
стрелкового	small
стрелковым	small
структурированного	structured
структурированные	structured
структурированный	structured
структурированных	structured
структурные	structural
структурных	structural
студентом	student
студенческими	student
студенческих	student
стульев	chairs
субботу	saturday
субрегиона	subregion
субрегионе	subregion
субстантивную	substantive
субститут	substitute
субститутов	substitutes
суверенитет	sovereignty
суверенитете	sovereignty
суверенитету	sovereignty
суверенного	sovereign
суверенное	sovereign
суверенной	sovereign
суверенном	sovereign
суверенную	sovereign
суверенные	sovereign
суверенными	sovereign
суверенных	sovereign
судане	sudan
судану	sudan
судей	judges
судимыми	tried
судимых	tried
суды	courts
сузан	susan
сузуки	suzuki
султана	sultan
султанат	sultanate
султаната	sultanate
султанате	sultanate
султанатом	sultanate
султанату	sultanate
султану	sultan
суммарных	summary
суперинтенданта	superintendent
суринам	suriname
суринама	suriname
суринаме	suriname
сходимся	understandings
сценариев	scenarios
сценарий	scenario
счаленных	formations
сырой	crude
сырую	crude
сюзанны	suzanne
табака	tobacco
табаком	tobacco
табачных	tobacco
таблица	table
таблице	table
таджикистан	tajikistan
таджикистане	tajikistan
таджикистаном	tajikistan
таджикские	tajik
таджикский	tajik
таджикских	tajik
таджикского	tajik
таджикское	tajik
таджикской	tajik
таиланду	thailand
тайване	taiwan
тайванем	taiwan
тайвань	taiwan
тайваня	taiwan
тайлер	tyler
тайным	secret
таксаций	inventories
такта	sensitivity
талибана	taliban
таллинне	tallinn
тамил	tamil
тамильскими	tamil
тамильских	tamil
тамильского	tamil
тамильской	tamil
таможенного	customs
таможенной	customs
таможенными	customs
таможенных	customs
танака	tanaka
танки	tanks
тапис	trips
таргетирования	targeting
тарифной	tariff
тарифные	tariff
тарифных	tariff
тахир	tahir
ташкент	tashkent
тбилиси	tbilisi
тегеран	tehran
тегерана	tehran
тегеране	tehran
тегеранский	tehran
тезауруса	thesaurus
тейлор	taylor
тейлора	taylor
тейлором	taylor
текстильная	textiles
телевидения	television
телегу	horse
телеком	telecom
телекоммуникаций	telecommunications
телерадиовещанию	powers
тельной	preparatory
теневая	shadow
теплопроизводительность	heating
терминала	terminal
терминальных	terminal
терминологии	terminology
тернбулл	turnbull
терпимости	tolerance
терпимость	tolerance
территориальной	territorial
территориальном	territorial
территориям	territories
территориях	territories
террор	terror
террора	terror
терроризма	terrorism
террористам	terrorists
террористические	terrorist
террористической	terrorist
террористскими	terrorist
террором	terror
тесно	closely
тесном	close
тестах	tests
техас	texas
техническую	technical
тибете	tibet
тибетом	tibet
тибетских	tibetan
тибету	tibet
тимор	timor
тиморе	timor
тимоти	timothy
типов	types
типового	model
типовые	model
типовым	model
типовых	model
типографских	printing
тирана	tirana
тирану	tirana
титула	title
тихого	pacific
тихоокеанских	pacific
тихоокеанского	pacific
тишине	silence
тобаго	tobago
токарных	restrictions
токийских	tokyo
токийского	tokyo
токийской	tokyo
токсикоманического	dependence
токсинами	toxins
токсинного	toxin
токсинном	toxin
токсических	toxic
токсичность	toxicity
токсичных	toxic
току	current
толика	grown
толкаемого	pushed
толкаемые	pushed
толкающих	drawing
толкованиях	interpretations
толкователь	interpreter
толстыми	steel
толщей	column
томаса	thomas
томах	volumes
томов	volumes
томпсон	thompson
томпсона	thompson
тонга	tonga
тонги	tonga
тонкодисперсными	particles
топографом	surveyor
торонто	toronto
торре	torre
травмировании	injury
трагедия	tragedy
трагические	tragic
традиционной	traditional
традиционных	traditional
транзакционные	transaction
транзита	transit
транзитных	transit
трансакционные	transaction
транснациональное	transnational
транснациональной	transnational
транснациональными	transnational
транснациональных	transnational
транспарантным	transparent
транспарентного	transparent
транспарентном	transparent
транспарентны	transparent
транспарентные	transparent
транспарентный	transparent
транспарентным	transparent
транспарентных	transparent
трансформирование	transforming
трастовой	company
траулерного	shrimp
требующемся	required
тревогах	concerns
третьего	third
третьем	third
третьим	third
трех	three
триаде	three
трибунала	tribunal
трибуналам	tribunals
трибуналах	tribunals
трибунале	tribunal
трибуналом	tribunal
трибуналы	tribunals
трибюн	tribune
триместре	quarter
тринадцатого	thirteenth
тринидаду	trinidad
триполи	tripoli
трон	throne
тропические	tropical
тропическими	tropical
тропической	tropical
труднодоступный	henderson
труднопреодолимыми	acute
трудящуюся	working
туберкулезу	tuberculosis
тувалу	tuvalu
тулуза	toulouse
туманных	vague
тунисского	tunisian
тунисскому	tunisian
туннелях	tunnels
турецким	turkish
турецкими	turkish
турецкого	turkish
турецкое	turkish
турецкой	turkish
туризм	tourism
туризма	tourism
туризмом	tourism
туризму	tourism
турине	turin
туркменистана	turkmenistan
туркменистане	turkmenistan
туркменистаном	turkmenistan
туркменистану	turkmenistan
турку	turku
турцию	turkey
тысячелетия	millennium
тысячи	thousands
тюркских	turkish
убедительности	credibility
убытием	departure
убыточным	detrimental
уважаемые	distinguished
уважалась	respected
уважаться	respected
увеличенное	increased
увеличивающий	feelings
уверовать	learn
увкб	unhcr
увольняет	laying
увязывающего	linking
угандийские	ugandan
угандийскими	ugandan
угандой	uganda
уганду	uganda
угасания	extinction
углеводородам	hydrocarbons
углеводородах	hydrocarbons
углеводороды	hydrocarbons
углубленных	in-depth
удвоиться	double
удержаны	retained
удовлетворительными	satisfactory
удовлетворяющему	satisfactory
уездам	counties
уездного	county
уездные	county
уездных	county
узбекистане	uzbekistan
узбекистаном	uzbekistan
узбекское	uzbek
узбекском	uzbek
узкоспециальным	specialized
уилкинсон	wilkinson
уилл	reaching
уильям	william
уильяма	william
украденного	stolen
украденных	stolen
украдены	stolen
украине	ukraine
украиной	ukraine
улаженного	unresolved
уличными	street
улучшенный	improved
уместить	public
умные	smart
умным	smart
универсален	universal
универсально	universally
универсальной	universal
универсальности	universality
универсальность	universality
универсальными	universal
универсальных	universal
университет	university
университетами	universities
университеты	universities
уникальную	unique
уникальный	unique
уникальным	unique
уникальных	unique
уньон	unión
уолтер	walter
уорриор	warrior
уполномочивать	authorize
уполномочить	authorize
уполномочию	authorized
уппсала	uppsala
уппсальский	uppsala
упрочив	strengthening
упрощены	simplified
урана	uranium
уранового	uranium
урбанизации	urbanization
урбанизация	urbanization
урегулировались	resolved
урегулированной	nature
урсула	ursula
уругвай	uruguay
уругвайскому	uruguay
уругвая	uruguay
услужение	clandestine
успех	success
установившая	deployed
устойчивое	sustainable
устраивающими	taken
уступке	assignment
уступлена	assigned
уступленной	assigned
усугубившиеся	caused
утвердившуюся	title
утверждавшимся	level
утех	comfort
утешать	comfort
утреннюю	sitting
утрехта	utrecht
утрехте	utrecht
утрехтского	utrecht
учитывавшихся	recognize
учреждаемым	established
уязвимые	vulnerable
уязвимым	vulnerable
факто	facto
фактологические	sheets
факультативному	optional
факультативный	optional
факультативным	optional
фармацевтическими	pharmaceutical
фармацевтического	pharmaceutical
фатальные	fatal
фауной	fauna
февраль	february
февраля	february
федерального	federal
федеральное	federal
федеральной	federal
федеральными	federal
федеративные	federated
федерацией	federation
федерации	federation
федерация	federation
феликсу	felix
фелипе	felipe
феминистских	feminist
феникс	phoenix
фенс	anchor
фермера	farmer
фернандо	fernando
феррейра	ferreira
физике	physics
физики	physics
физической	physical
фиксированные	fixed
фиксирующего	forth
филадельфии	philadelphia
филиале	branch
филиппинах	philippines
филиппины	philippines
философия	philosophy
философский	philosophical
философскими	philosophical
философского	philosophical
фильтр	filter
фильтрующим	filter
финансистов	financiers
финансовой	financial
финляндия	finland
финниша	finnish
финских	finnish
финское	finnish
фискальной	fiscal
флавия	flavia
фламандский	flemish
фламандских	flemish
фламандского	flemish
фландрии	flanders
фландрия	flanders
флорес	flores
флореса	flores
флорида	florida
флориде	florida
фондового	stock
фондовые	stock
фоновой	background
формат	format
форматах	formats
форматов	formats
форматы	formats
форум	forum
форума	forum
фотограф	photographer
фотографической	photographic
фотоконкурс	photo
фотоэлектрического	photovoltaic
фрагментацией	fragmentation
фрагментация	fragmentation
фракии	thrace
фракциями	factions
франклина	franklin
франкфурта	frankfurt
франкфурте	frankfurt
франкфуртской	frankfurt
франсис	francis
франсуа	françois
франции	france
франция	france
французском	french
фрахта	freight
фрибуре	fribourg
фритаун	freetown
фритауна	freetown
фритауне	freetown
фруктам	codex
фукс	fuchs
функционировавшей	functioning
фьючерсные	futures
хабеас	habeas
хабитат	habitat
хавьер	javier
хавьера	javier
хавьером	javier
халатном	services
халед	khaled
халил	khalil
халиско	jalisco
халифе	khalifa
хамад	hamad
хамада	hamad
хамадом	hamad
хамдан	hamdan
хамид	hamid
хандикап	handicap
хансена	hansen
характеризовавшийся	expand
харальд	harald
хараре	harare
харарской	harare
харарскую	harare
харпер	harper
харрис	harris
харриса	harris
хартума	khartoum
хартуме	khartoum
хартумом	khartoum
хартумскую	khartoum
хассан	hassan
хеврон	hebron
хеврона	hebron
хевроне	hebron
хевронских	hills
хельсинки	helsinki
хельсинкская	helsinki
хельсинкских	helsinki
хельсинкского	helsinki
хельсинкской	helsinki
хенрика	henrik
хесуса	jesús
хименеса	jiménez
химическое	chemical
химию	chemistry
хинду	hindu
хлопка	cotton
хлопком	cotton
хлопок	cotton
хлор	chlorine
хлором	chlorine
хлынул	influx
ходатай	applicant
холокост	holocaust
хорватией	croatia
хорватии	croatia
хорватия	croatia
хорватском	croatian
хорхе	jorge
хосе	josé
хоффмана	hoffmann
храмовая	temple
храмовой	temple
хрестоматийным	textbook
христианские	christian
христианским	christian
христианских	christian
христианского	christian
христианской	christian
христианство	christianity
христианством	christianity
хрупок	fragile
хуанхэ	yellow
хувентуд	juventud
хунта	junta
хунтой	junta
хьюз	hughes
хьюман	watch
царящего	prevailing
целеопределении	australian
целостность	integrity
целостный	holistic
цемент	cement
цемента	cement
цементной	cement
ценнейшего	precious
ценностное	judgement
ценностям	values
ценную	valuable
ценный	valuable
ценообразованию	pricing
центральноафриканская	central
центральноафриканских	central
центральноафриканской	central
центральной	central
церквам	churches
церквей	churches
церквям	churches
церквях	churches
цзян	jiang
цивилизационную	imposition
цикл	cycle
циркуляре	circular
циркулярное	circular
циркуляром	circular
цитате	passage
цитируемая	quoted
цитируемого	quoted
цитируемое	quoted
цитрусовые	citrus
цитрусовых	citrus
цифровой	digital
цокольном	basement
чандра	chandra
чарлз	charles
чарльз	charles
чарльза	charles
чартерные	flights
частного	private
частном	private
частным	private
частых	frequent
чейз	chase
человечности	humanity
человечность	humanity
чернобылю	chernobyl
черногорией	montenegro
черногорию	montenegro
черногория	montenegro
чернокожего	black
черном	black
черноморского	black
черными	black
четверг	thursday
четвертого	fourth
четырнадцатого	fourteenth
чеченскими	chechen
чеченских	chechen
чечне	chechnya
чечни	chechnya
чечню	chechnya
чжан	zhang
чиангмае	chiang
чиангмайская	chiang
чиангмайской	chiang
чиапас	chiapas
чиапасе	chiapas
чикаго	chicago
чикагская	chicago
чилийских	chilean
чистками	cleansing
чистки	cleansing
читтагонга	tracts
читтагонгского	chittagong
чонг	chong
чрезмерны	excessive
чувствителен	sensitive
чувствительной	sensitive
чувствительных	sensitive
чудодейственного	bullet
чуждой	alien
чужеземным	domination
чхуна	chung
чэн	cheng
шанхае	shanghai
шанхайской	shanghai
шанхайскую	shanghai
шардже	sharjah
шарлот	charlotte
шарлотт	charlotte
шарлотта	charlotte
шарма	sharma
шарон	sharon
шару	globe
шведов	swedish
шведский	swedish
шведским	swedish
шведского	swedish
швейцарию	switzerland
швейцарцами	swiss
швейцарцев	swiss
швецию	sweden
шейла	sheila
шельфа	shelf
шельфе	shelf
шельфом	shelf
шестнадцатого	sixteenth
шестнадцатой	sixteenth
шестнадцатый	sixteenth
шестнадцатых	sixteenth
шестого	sixth
шестом	sixth
шкал	scales
шкала	scale
шкалам	scales
шкалах	scales
шкале	scale
шоковым	shocks
шотландским	scottish
шприцам	infections
штайнер	steiner
штайнера	steiner
штайнером	steiner
штатное	staffing
шторм	storm
штормовых	storm
штутгарт	stuttgart
штутгарте	stuttgart
шумовому	pollution
шумовым	noise
щиту	panels
эберт	ebert
эберта	ebert
эвакуировали	evacuated
эванс	evans
эвентуально	therein
эгейское	aegean
эдварда	edward
эдгара	edgar
эдинбург	edinburgh
эдинбурге	edinburgh
эдмунда	edmund
эдуардо	eduardo
эйбрахам	abraham
эйруэйз	airways
эквадоре	ecuador
эквадором	ecuador
экватора	equator
эквивалентного	equivalent
эквивалентной	equivalent
эквивалентную	equivalent
эквивалентные	equivalent
эквивалентный	equivalent
эквивалентным	equivalent
эквивалентных	equivalent
экзаменационную	rating
экзаменования	examination
экипированы	equipped
экологизацию	greening
экономическим	economic
экономических	economic
экономического	economic
экономической	economic
экономичному	economical
эксклюзивного	exclusive
эксклюзивность	markets
экскрементах	excretion
эксперимент	experiment
экспериментах	experiments
эксперт	expert
эксперта	expert
экспертами	experts
эксперты	experts
эксплицитного	explicit
эксплицитной	explicit
эксплицитным	explicit
эксплуатировался	exploited
экспортированных	exported
экспортироваться	exported
экспортируются	exported
экспортирующими	exporting
экспортируя	exporting
экспортного	export
экстремизм	extremism
экстремизма	extremism
экстремизмом	extremism
экстремизму	extremism
эктор	héctor
экуменических	ecumenical
экуменического	ecumenical
электричества	electricity
электричеству	electricity
электродвигателя	electric
электродуговых	furnaces
электролита	anode
электронами	ionization
электронике	electronics
электроники	electronics
электронных	electronic
электроприборов	appliances
электроснабжению	electricity
электростанцией	either
электроэнергоснабжение	electricity
эмансипации	emancipation
эмбрионы	embryos
эмиратах	emirates
эмпирические	empirical
эмпирических	empirical
эмпирической	empirical
энвер	enver
эндрю	andrew
энергетика	energy
энергетики	energy
энергоемкость	intensity
энкор	anchor
энтерпрайзиз	enterprises
энтони	anthony
энциклопедии	encyclopaedia
эпидемиологическими	epidemiological
эпидемиологических	epidemiological
эпидемиологическое	epidemiological
эпидемиологической	epidemiological
эпидемиологическую	epidemiological
эпидемиология	epidemiology
эрвин	erwin
эритрейские	eritrean
эритрейских	eritrean
эритрейского	eritrean
эритрейское	eritrean
эритрейской	eritrean
эритрейскую	eritrean
эритрею	eritrea
эритрея	eritrea
эрнандеса	hernández
эрнеста	ernest
эрнесто	ernesto
эрнст	ernst
эруэйз	airways
эскадрона	squad
эскимосы	inuit
эскобара	escobar
эстонию	estonia
эстония	estonia
эстонского	estonian
эстонском	estonian
этажах	floors
этажи	floors
этикой	ethics
этические	ethical
этнические	ethnic
этнического	ethnic
эухении	eugenia
эухения	eugenia
эфиопию	ethiopia
эфиопских	ethiopian
эфиопской	ethiopian
юбер	hubert
юбера	hubert
югославией	yugoslavia
югославия	yugoslavia
южноафриканцев	africans
юкио	yukio
юнайтс	unites
юнидо	unido
юнисеф	unicef
юный	young
юргена	jürgen
юрисдикцией	jurisdiction
юрисдикционные	jurisdictional
юрисдикционным	jurisdictional
юрисдикциях	jurisdictions
юропкар	italia
юсуфа	yusuf
юсуфом	yusuf
юсэйд	usaid
яблок	apples
яблоки	apples
явкой	appearance
ядерного	nuclear
ядерное	nuclear
ядерной	nuclear
ядерному	nuclear
языка	language
языковым	linguistic
ямайка	jamaica
ямайке	jamaica
январь	january
январю	january
января	january
янине	ioannina
японии	japan
япония	japan
японские	japanese
японскими	japanese
японских	japanese
ярдов	yards
ярослав	jaroslav
ярчайших	stories
ясир	yasser
ясиром	yasser
ясиру	yasser
ящиках	boxes
