aachen	ахен
aalborg	ольборг
aalst	алст
aarau	арау
aarhus	орхус
abad	абад
abadan	абадан
abakan	абакан
abas	абас
abaza	абаза
abbeville	абвиль
abdullah	абдуллах
aberdeen	абердин
aberdeenshire	абердиншир
abhazlar	абхазы
abhazya	абхазия
abidjan	абиджан
abruzzo	абруцци
abuja	абуджа
acanthaceae	акантовые
acapulco	акапулько
accrington	аккрингтон
achillea	тысячелистник
acinonyx	гепарды
aconcagua	аконкагуа
actitis	перевозчики
acıma	жалость
adachi	адати
adad	адад
adalet	правосудие
adams	адамс
adana	адана
adanaspor	аданаспор
aden	аден
adour	адур
adrenalin	адреналин
adria	адрия
adriano	адриано
adsorpsiyon	адсорбция
adıyaman	адыяман
aeneas	эней
aerodinamik	аэродинамика
aerodrom	аэродром
afet	катастрофа
afganistan	афганистан
afiş	плакат
aforoz	отлучение
afrika	африка
afrikaans	африкаанс
afrin	африн
afro	афро
afrodit	афродита
afşar	афшар
agamemnon	агамемнон
agaricus	шампиньон
agatokles	агафокл
agen	ажен
agni	агни
agonist	агонист
agora	агора
agra	агра
agrigento	агридженто
aguti	агути
ahaya	ахея
ahlak	мораль
ahmedabad	ахмадабад
ahmeta	ахмета
ahmetov	ахметов
ahnenerbe	аненербе
ahtapot	осьминоги
ahududu	малина
ahvaz	ахваз
ahılkelek	ахалкалаки
ahır	хлев
ahıska	ахалцихе
ahşap	лесоматериалы
aida	аида
aikido	айкидо
aile	семья
ainur	айнур
aira	айра
ajaccio	аяччо
ajans	агентство
ajax	аякс
akabe	акаба
akademi	академия
akademisyen	академик
akalar	ахейцы
akasaka	акасака
akathist	акафист
akciğer	лёгкие
aken	акен
akershus	акерсхус
akhisar	акхисар
akihito	акихито
akik	агат
akita	акита
akka	акко
akor	аккорд
akra	аккра
akrabalık	родство
akranes	акранес
akrep	скорпионы
akrobasi	акробатика
akron	акрон
akronim	акроним
akropolis	акрополь
aksakallı	аксакал
aksaray	аксарай
aksesuar	аксессуар
aksiyom	аксиома
aksiyon	акция
aksu	аксу
aktau	актау
aktinyum	актиний
aktöbe	актобе
akustik	акустика
akvaryum	аквариум
akıl	рассудок
akım	аким
akşam	вечер
alabalık	форель
alabama	алабама
alacahisar	крушевац
alagoas	алагоас
alagöl	алаколь
alan	площадь
alanin	аланин
alanlar	аланы
alanya	аланья
alaska	аляска
alay	полк
alazani	алазани
alaş	алаш
alba	альба
albacete	альбасете
albany	олбани
albay	полковник
albemarle	албемарл
alberta	альберта
albertville	альбервиль
albi	альби
albuquerque	альбукерке
alcorcón	алькоркон
aldebaran	альдебаран
alderney	олдерни
aldershot	олдершот
alegori	аллегория
alejandro	алехандро
alel	аллели
alençon	алансон
alerji	аллергия
alessandria	алессандрия
alet	инструмент
alev	пламя
alex	алекс
alexanderplatz	александерплац
alfabe	алфавит
alfie	алфи
algarve	алгарви
algeciras	альхесирас
algoritma	алгоритм
algı	восприятие
alicante	аликанте
alizée	ализе
alkaloid	алкалоиды
alkazar	алькасар
alken	алкены
alkmaar	алкмар
alkmaion	алкмеон
alkol	спирты
alkolizm	алкоголизм
alkış	аплодисменты
allah	аллах
allan	аллан
alle	аллея
allegheny	аллегейни
allende	альенде
allgäu	алльгой
allier	алье
allık	румяна
almada	алмада
almagest	альмагест
almalık	алмалык
almanak	альманах
almanya	германия
almas	алмас
almelo	алмело
almere	алмере
almería	альмерия
almodovar	альмодовар
alonso	алонсо
alpine	алпайн
alpler	альпы
alsas	эльзас
alsu	алсу
alta	алта
altair	альтаир
altdev	субгигант
altenburg	альтенбург
altiplano	альтиплано
altkültür	субкультура
altyapı	инфраструктура
altyazı	субтитры
altıgen	шестиугольник
altın	золото
altıpatlar	револьвер
aluşta	алушта
alytus	алитус
alyuvar	эритроциты
alçı	штукатурка
alüminyum	алюминий
alþingi	альтинг
alınlık	фронтон
amadora	амадора
amalfi	амальфи
aman	аман
amanita	мухомор
amapá	амапа
amasya	амасья
amaterasu	аматэрасу
amazonlar	амазонки
ambalaj	упаковка
ambargo	эмбарго
amber	амбер
amberg	амберг
amblem	эмблема
amboise	амбуаз
ambon	амвон
amedeo	амедей
amelia	амелия
amerika	америка
amersfoort	амерсфорт
ametist	аметист
amfibiler	земноводные
amfitiyatro	амфитеатр
amfora	амфора
amiens	амьен
amigo	амиго
amin	амин
amit	амиды
amman	амман
amnezi	амнезия
amonyak	аммиак
amonyum	аммоний
amortisör	амортизатор
amper	ампер
ampezzo	ампеццо
ampütasyon	ампутация
amritsar	амритсар
amstelveen	амстелвен
amsterdam	амстердам
amélie	амели
anadır	анадырь
anafor	водоворот
anagni	ананьи
anagram	анаграмма
analist	аналитик
analog	аналог
analoji	аналогия
ananas	ананас
ananasgiller	бромелиевые
ananda	ананда
anarşizm	анархизм
anasaziler	анасази
anason	анис
anat	анат
anatidae	утиные
anatomi	анатомия
anayasa	конституция
ancona	анкона
anderlecht	андерлехт
andersson	андерссон
andican	андижан
andong	андон
andorra	андорра
andrew	эндрю
andria	андрия
andromahi	андромаха
andromeda	андромеда
andronikos	андроник
andújar	андухар
anemone	ветреница
anestezi	анестезия
angelica	дудник
angers	анже
angkor	ангкор
anglesey	англси
anglikanizm	англиканство
angola	ангола
angoulême	ангулем
anguilla	ангилья
angus	ангус
anhalt	анхальт
anhui	аньхой
animasyon	мультипликация
anime	аниме
animizm	анимизм
ankara	анкара
anklam	анклам
anksiyete	тревога
anlatıcı	рассказчик
annapurna	аннапурна
anne	мать
annecy	анси
annonay	анноне
anoreksi	анорексия
anot	анод
anouk	анук
anqing	аньцин
ansan	ансан
ansbach	ансбах
anshan	аньшань
ansiklopedi	энциклопедия
antaios	антей
antakya	антакья
antalya	анталья
antalyaspor	антальяспор
antananarivo	антананариву
antares	антарес
antarktik	антарктика
antarktika	антарктида
antequera	антекера
antibes	антиб
antigone	антигона
antigua	антигуа
antijen	антиген
antika	антиквариат
antikomünizm	антикоммунизм
antikor	антитела
antilop	антилопы
antimon	сурьма
antioquia	антьокия
antipapa	антипапа
antisemitizm	антисемитизм
antiseptik	антисептики
antrasit	антрацит
antrenman	тренинг
antrenör	тренер
antrepo	склад
antropoloji	антропология
antsiranana	анциранана
anubis	анубис
anvers	антверпен
anyang	аньян
anzio	анцио
anzoátegui	ансоатеги
anápolis	анаполис
anüs	анус
anıt	памятник
aomori	аомори
aosta	аоста
aoyama	аояма
apartman	квартира
apatin	апатин
apatit	апатит
aperitif	аперитив
apia	апиа
apiaceae	зонтичные
apocynaceae	кутровые
apokrif	апокриф
apollon	аполлон
apollonia	аполлония
apollonios	аполлоний
apoptozis	апоптоз
apse	абсцесс
aptallık	глупость
aquila	орлы
arabulucu	медиатор
aracaju	аракажу
araf	чистилище
arafat	арафат
aragon	арагон
aragua	арагуа
aranjör	аранжировка
arapaho	арапахо
araplar	арабы
aras	аракс
arazi	рельеф
araştırma	исследование
araştırmacı	исследователь
arboretum	дендрарий
arcos	аркос
ardea	цапли
ardıç	можжевельник
arequipa	арекипа
ares	арес
arezzo	ареццо
argeș	арджеш
argo	сленг
argon	аргон
argonotlar	аргонавты
argun	аргун
arhangelsk	архангельск
ariadne	ариадна
arica	арика
ariel	ариэль
aristofanes	аристофан
aristokrasi	аристократия
aristoteles	аристотель
aritmetik	арифметика
arius	арий
arizona	аризона
ariège	арьеж
arjaan	аржан
arjantin	аргентина
arjuna	арджуна
arkansas	арканзас
arkas	аркад
arkea	археи
arkeen	архей
arkeoloji	археология
arkhon	архонт
arktika	арктика
arleken	арлекин
arles	арль
arlington	арлингтон
arlon	арлон
arma	герб
armada	армада
armageddon	армагеддон
armagh	арма
armani	армани
armatür	светильник
armavir	армавир
armix	арми
armstrong	армстронг
armut	груша
armyansk	армянск
arnavutlar	албанцы
arnavutluk	албания
arnhem	арнем
arnold	арнольд
arnsberg	арнсберг
arnstadt	арнштадт
aroma	ароматизаторы
arouca	арока
arpağ	заклинание
arpej	арпеджио
arras	аррас
arsenik	мышьяк
artaserhas	артаксеркс
artaşat	арташат
artek	артек
artemis	артемида
artemisa	артемиса
arthur	артур
artrit	артрит
artsah	арцах
artvin	артвин
artyakıcı	форсаж
aruba	аруба
aruna	аруна
arusha	аруша
arya	ария
aryan	арии
arzu	желание
arça	арск
arıcılık	пчеловодство
arşidük	эрцгерцог
arşimet	архимед
arşiv	архив
arşivci	архивист
arşın	аршин
asahikawa	асахикава
asakusa	асакуса
asbest	асбест
aschaffenburg	ашаффенбург
asena	арсена
asenovgrad	асеновград
asetilen	ацетилен
aseton	ацетон
asfalt	асфальт
asiago	азиаго
asil	дворянство
asimetri	асимметрия
asimilasyon	ассимиляция
asit	кислоты
asker	солдат
asklepios	асклепий
asma	лоза
asparuh	аспарух
assam	ассам
assembler	ассемблер
assisi	ассизи
astana	астана
astane	астане
astar	подкладка
aster	астер
asteroit	астероид
asti	асти
astragalus	астрагал
astrahan	астрахань
astrofizik	астрофизика
astrolog	астролог
astroloji	астрология
astronom	астроном
astronomi	астрономия
astronot	космонавт
astronotik	космонавтика
astropika	субтропики
asturias	астурия
asunción	асунсьон
asvan	асуан
asya	азия
asyut	асьют
atabask	атабаска
atabeg	атабек
ataerkillik	патриархат
atahualpa	атауальпа
ataksi	атаксия
ataman	атаман
atanasov	атанасов
atardamar	артерия
atasözü	пословица
ataşe	атташе
ateroskleroz	атеросклероз
ateş	огонь
atgiller	лошадиные
athena	афина
athenagoras	афинагор
athene	сычи
atina	афины
atkı	шарф
atlanta	атланта
atlantis	атлантида
atlas	атлас
atlántico	атлантико
atlıkarınca	карусель
atmosfer	атмосфера
atom	атом
aton	атон
atrofi	атрофия
atropin	атропин
atsugi	ацуги
attika	аттика
attila	аттила
atölye	ателье
atırau	атырау
aubenas	обена
augsburg	аугсбург
aura	аура
aurelia	аврелия
aurelianus	аврелиан
aurillac	орийак
auvergne	овернь
aval	аваль
avalon	авалон
avarlar	авары
avatar	аватара
aveiro	авейру
avellino	авеллино
aversa	аверса
avesta	авеста
aveyron	аверон
avignon	авиньон
avilés	авилес
avitus	авит
aviyonik	авионика
avize	люстра
avlonya	влёра
avlu	атриум
avni	авни
avogadro	авогадро
avokado	авокадо
avranches	авранш
avrasya	евразия
avrupa	европа
avukat	адвокат
avustralya	австралия
avusturya	австрия
ayacucho	аякучо
ayak	стопа
aybeg	айбек
aydos	айтос
aydınlatma	иллюминация
ayetullah	аятолла
ayin	ритуал
aylesbury	эйлсбери
aymaralar	аймара
ayrılıkçılık	сепаратизм
ayrımcılık	дискриминация
ayutthaya	аюттхая
ayva	айва
ayıhı	айыы
ayşe	айше
azak	азов
azap	страдание
azerbaycan	азербайджан
azerbaycanfilm	азербайджанфильм
azeriler	азербайджанцы
azimut	азимут
azis	азис
azot	азот
aztekler	ацтеки
açelya	азалия
açinsk	ачинск
açlık	голодание
açıklama	объяснение
ağayev	агаев
ağaç	дерево
ağaçlık	редколесье
ağdam	агдам
ağdaş	агдаш
ağizel	агидель
ağlama	плач
ağrı	агры
ağsu	ахсу
ağustos	август
ağıl	загон
ağıt	элегия
aşdod	ашдод
aşina	ашина
aşiret	племя
aşkabat	ашхабад
aşkelon	ашкелон
aşram	ашрам
aştarak	аштарак
aşçı	повар
aşçılık	кулинария
aşılama	вакцинация
aşırılık	экстремизм
baal	баал
baalbek	баальбек
babruysk	бобруйск
babür	бабур
bacak	нога
badajoz	бадахос
badami	бадами
badi	бади
badminton	бадминтон
baekje	пэкче
bagaj	багаж
bagan	паган
bahar	бахар
baharat	пряности
bahia	баия
bahreyn	бахрейн
bahçecilik	садоводство
bahçıvan	садовник
bahş	бахш
bakal	бакал
bakan	министр
bakanlık	министерство
bakar	бакар
bakker	баккер
baksı	бахши
bakteri	бактерии
bakumatsu	бакумацу
bakü	баку
bakır	медь
balaban	балабан
balad	баллада
balakovo	балаково
balalayka	балалайка
balaşiha	балашиха
bale	балет
balhae	бохай
bali	бали
balina	киты
balinalar	китообразные
balistik	баллистика
balkarya	балкария
balkon	балкон
ballard	баллард
ballıbabagiller	яснотковые
balsam	бальзам
balta	топор
baltimore	балтимор
balçık	бельцы
balık	рыбы
balıkesir	балыкесир
bamberg	бамберг
bande	банде
bandung	бандунг
bandura	бандура
bangalore	бангалор
bangkok	бангкок
bangladeş	бангладеш
bangui	банги
banjo	банджо
bank	скамья
banka	банк
banknot	банкнота
banks	банкс
banliyö	пригород
banshee	банши
bansko	банско
banten	бантен
bantu	банту
bantustan	бантустан
baoji	баоцзи
baotou	баотоу
baraj	плотина
barakaldo	баракальдо
barbar	варвары
barbastro	барбастро
barbu	барбу
barbuda	барбуда
bardas	варда
bari	бари
barisal	барисал
bariton	баритон
bariyer	барьер
barmen	бармен
barnaul	барнаул
barok	барокко
baron	барон
barquisimeto	баркисимето
barranquilla	барранкилья
barreiro	баррейру
barselona	барселона
barut	порох
baryum	барий
basel	базель
basilicata	базиликата
basilisk	василиск
basketbol	баскетбол
basklar	баски
basra	басра
bast	баст
bastia	бастия
bastogne	бастонь
baston	трость
basınç	давление
bataysk	батайск
batmazlık	плавучесть
batnaz	патмос
battaniye	одеяло
batum	батуми
batı	запад
baum	баум
baumann	бауман
bauru	бауру
bautzen	баутцен
bavyera	бавария
bayanhongor	баянхонгор
bayeux	байё
bayonne	байонна
bayrak	флаг
bayram	праздник
bayreuth	байройт
bayt	байт
baza	база
bazilika	базилика
baçka	бачка
bağdat	багдад
bağımsızlık	независимость
bağırsak	кишечник
bağış	пожертвование
bağışıklık	иммунитет
başak	колос
başakşehir	башакшехир
başkalaşım	метаморфоз
başkan	президент
başkent	столица
başkomutan	главнокомандующий
başkurdistan	башкортостан
başkurtlar	башкиры
başörtüsü	платок
beatrix	беатрикс
beauvoir	бовуар
bebek	младенец
bechuanaland	бечуаналенд
bedahşan	бадахшан
bedeviler	бедуины
bedford	бедфорд
bedfordshire	бедфордшир
beeline	билайн
begüm	бегум
beira	бейра
beja	бежа
beka	живучесть
bekabad	бекабад
bekâret	девственность
belarus	белоруссия
belarusfilm	беларусьфильм
belas	белаш
belediye	муниципалитет
belfast	белфаст
belfort	бельфор
belge	документ
belgeleme	документация
belgorod	белгород
belgrad	белград
belirti	симптом
belize	белиз
bell	белл
bellek	память
belley	белле
bellini	беллини
bellinzona	беллинцона
belluno	беллуно
beloretsk	белорецк
belucistan	белуджистан
belçika	бельгия
bema	вима
bender	бендеры
benevento	беневенто
bengal	бенгалия
benidorm	бенидорм
benin	бенин
bentos	бентос
benue	бенуэ
benzen	бензол
beowulf	беовульф
berane	беране
berat	берат
berberiler	берберы
berchtesgaden	берхтесгаден
bere	берет
berezniki	березники
bergamo	бергамо
berger	бергер
bergerac	бержерак
bergman	бергман
berilyum	бериллий
bering	беринг
berkeley	беркли
berkshire	беркшир
berlin	берлин
berliner	берлинер
berman	берман
bern	берн
berna	берна
bernard	бернар
bernburg	бернбург
berra	берра
berre	парос
besançon	безансон
besarabya	бессарабия
beslan	беслан
beslenme	питание
besteci	композитор
beta	бета
beton	бетон
betonarme	железобетон
betulaceae	берёзовые
beveren	беверен
beverley	беверли
beyanname	декларация
beyazıt	баязид
beyoncé	бейонсе
beyoğlu	бейоглу
beyrut	бейрут
beyzbol	бейсбол
bezeme	орнамент
bełchatów	белхатув
beşgen	пятиугольник
beşik	колыбель
bhakti	бхакти
bhopal	бхопал
bhutan	бутан
bianco	бьянко
biarritz	биарриц
biatlon	биатлон
białystok	белосток
bibliyografya	библиография
biblos	библ
bielefeld	билефельд
bienal	биеннале
bihaç	бихач
bikini	бикини
bilal	билял
bilardo	бильярд
bilbao	бильбао
bileklik	браслет
bilet	билет
bilgelik	мудрость
bilgi	знание
bilgisayar	компьютер
bilim	наука
bilinç	сознание
bilişsellik	познание
bilmece	загадка
bina	здание
binbaşı	майор
bingazi	бенгази
bingo	бинго
binyıl	тысячелетие
bira	пиво
biracılık	пивоварение
birey	индивид
bireycilik	индивидуализм
biricik	единственность
birim	юнит
birmingham	бирмингем
bisiklet	велосипед
biskay	бискайя
bissau	бисау
bistro	бистро
bitburg	битбург
bitcoin	биткойн
bitinya	вифиния
bitki	растения
bitlis	битлис
bitüm	битум
bivalvia	двустворчатые
biyocoğrafya	биогеография
biyofizik	биофизика
biyografi	биография
biyokimya	биохимия
biyokütle	биомасса
biyoloji	биология
biyopsi	биопсия
biyosfer	биосфера
biyoteknoloji	биотехнология
biyotit	биотит
biyoyararlanım	биодоступность
biyoçeşitlilik	биоразнообразие
biysk	бийск
bizantion	византий
bizmut	висмут
biçimcilik	формализм
bişkek	бишкек
bjelovar	бьеловар
björk	бьорк
blackburn	блэкберн
blackpool	блэкпул
blade	блэйд
blagoveşçensk	благовещенск
bled	блед
blitz	блиц
bloemfontein	блумфонтейн
blog	блог
blois	блуа
blok	блок
blokflüt	блокфлейта
blondi	блонди
bloom	блум
bloomington	блумингтон
bludenz	блуденц
bluegrass	блюграсс
blues	блюз
blumenau	блуменау
bobigny	бобиньи
bobsled	бобслей
bochum	бохум
bodhi	бодхи
bodhisattva	бодхисаттва
bodø	будё
boemondo	боэмунд
boethius	боэций
bogotá	богота
bohemya	богемия
bohuslän	бохуслен
bokeh	боке
bokmål	букмол
boks	бокс
bolivya	боливия
bolnisi	болниси
bolu	болу
bomba	бомба
bombus	шмели
bonaventura	бонавентура
boncuk	бусы
bond	бонд
bong	бонг
bonn	бонн
bonsai	бонсай
borba	борба
boreas	борей
bormio	бормио
borna	борна
borneo	калимантан
bornholm	борнхольм
borsa	биржа
borås	бурос
borç	долг
bosna	босния
bosnalılar	боснийцы
boston	бостон
botanik	ботаника
botevgrad	ботевград
botoșani	ботошани
botsvana	ботсвана
bounty	баунти
boyacá	бояка
boyama	раскраска
boyar	бояре
boyko	бойко
boykot	бойкот
boylam	долгота
bozkır	степь
bozon	бозон
boşanma	развод
braconidae	бракониды
bradford	брадфорд
bradikardi	брадикардия
bradley	брэдли
bragi	браги
brahma	брахма
brahman	брахман
brainin	брайнин
branco	бранко
brandenburg	бранденбург
brandon	брандон
branta	казарки
brasília	бразилиа
bratislava	братислава
bratsk	братск
bratunac	братунац
brauer	брауэр
braunschweig	брауншвейг
brazzaville	браззавиль
brač	брач
braşov	брашов
breda	бреда
bregenz	брегенц
bremen	бремен
bremerhaven	бремерхафен
brescia	брешиа
bretonya	бретань
brezilya	бразилия
brezilyalılar	бразильцы
briançon	бриансон
bridgeport	бриджпорт
brighton	брайтон
brindisi	бриндизи
brisbane	брисбен
bristol	бристоль
britonlar	бритты
brixen	брессаноне
briç	бридж
brno	брно
broadway	бродвей
broker	маклер
brokoli	брокколи
brom	бром
bronz	бронза
bronşit	бронхит
brooklyn	бруклин
brown	браун
broşür	брошюра
brugge	брюгге
brunei	бруней
bruno	бруно
bryansk	брянск
brück	брюк
bucaramanga	букараманга
buckinghamshire	бакингемшир
bucks	бакс
buda	будда
budapeşte	будапешт
budin	буда
budizm	буддизм
budo	будо
budva	будва
bugojno	бугойно
bugsy	багси
buhara	бухара
buharlaşma	испарение
bujumbura	бужумбура
bukalemun	хамелеоны
bukavu	букаву
bukovina	буковина
bulantı	тошнота
bulanıklık	неоднозначность
buldozer	бульдозер
bulgaristan	болгария
bulgarlar	болгары
bulletin	бюллетень
bulmaca	головоломка
bulut	облака
bulvar	бульвар
bumerang	бумеранг
bundeswehr	бундесвер
bungalov	бунгало
bunkyō	бункё
burbank	бербанк
burgaz	бургас
burgdorf	бургдорф
burgenland	бургенланд
burghausen	бургхаузен
burgos	бургос
burjuvazi	буржуазия
burlesk	бурлеск
burnley	бернли
burs	стипендия
burundi	бурунди
buryatya	бурятия
burşun	акбузат
busan	пусан
buskerud	бускеруд
butik	бутик
buynaksk	буйнакск
buza	бузэу
buzdağı	айсберг
buzdolabı	холодильник
buzkıran	ледокол
buzuki	бузуки
buzul	ледник
buzuluk	бузулук
buşehr	бушир
bydgoszcz	быдгощ
bytom	бытом
béarn	беарн
békéscsaba	бекешчаба
béthune	бетюн
béziers	безье
böblingen	бёблинген
böbrek	почка
böcek	насекомые
bölge	регион
bügülme	бугульма
bükreş	бухарест
bürokrasi	бюрократия
bütçe	бюджет
büyü	магия
büyükanne	бабушка
büyüklük	великий
büzgen	сфинктер
cabbar	джаббар
cabriolet	кабриолет
caduceus	кадуцей
cadılık	колдовство
cafu	кафу
cagayan	кагаян
cagliari	кальяри
caithness	кейтнесс
cakarta	джакарта
calabria	калабрия
calais	кале
calama	калама
caldas	кальдас
calgary	калгари
caligula	калигула
callao	кальяо
calluna	вереск
caltanissetta	кальтаниссетта
calw	кальв
camala	джамала
cambrai	камбре
cambridge	кембридж
cambridgeshire	кембриджшир
camden	камден
camerino	камерино
cami	мечеть
caminha	каминья
campobasso	кампобассо
canavar	чудовище
canberra	канберра
cancún	канкун
canelones	канелонес
caneva	канева
cangzhou	цанчжоу
canis	волки
canköy	джанкой
canlı	организм
cannes	канны
cantabria	кантабрия
cantal	канталь
canterbury	кентербери
cantù	канту
capitol	капитолий
capoeira	капоэйра
capri	капри
capua	капуя
carabidae	жужелицы
carabobo	карабобо
caracalla	каракалла
caracas	каракас
carassius	караси
caravaggio	караваджо
carcassonne	каркасон
cardiff	кардифф
cardinalis	кардиналы
carduus	чертополох
carignano	кариньяно
carillon	карильон
carpentras	карпантра
carrara	каррара
carrie	керри
carroll	кэрролл
cartagena	картахена
carter	картер
caryophyllaceae	гвоздичные
caryophyllales	гвоздичноцветные
cascais	кашкайш
caserta	казерта
cassander	кассандр
cassino	кассино
castelli	кастелли
castra	каструм
castries	кастри
castro	кастро
casusluk	шпионаж
catanzaro	катандзаро
cauca	каука
cavalılar	яванцы
cavanşir	джеваншир
cavite	кавите
cayenne	кайенна
caynizm	джайнизм
ceará	сеара
cebelitarık	гибралтар
cebir	алгебра
cehalet	невежество
ceket	куртка
celje	целе
cellat	палач
celle	целле
cemaat	джамаат
cemmu	джамму
cemâl	джамаль
cenevre	женева
cengel	джунгли
cennet	небеса
cenova	генуя
cent	цент
centaur	центавр
centaurea	василёк
centilmen	джентльмен
centurio	центурион
cephanelik	арсенал
cermenler	германцы
cerrahi	хирургия
cesaret	мужество
cesena	чезена
ceset	труп
cetvel	линейка
ceyhan	джейхан
ceyhun	амударья
ceylan	газели
ceza	наказание
cezaevi	тюрьма
cezayir	алжир
cezve	турка
chagang	чагандо
challenger	челленджер
chambéry	шамбери
changzhi	чанчжи
changzhou	чанчжоу
chapecoense	шапекоэнсе
chardonnay	шардоне
charente	шаранта
charleroi	шарлеруа
charleston	чарлстон
charmed	зачарованные
chengde	чэндэ
chennai	ченнаи
chersonesos	херсонес
chester	честер
chełm	хелм
chiapas	чьяпас
chiayi	цзяи
chicago	чикаго
chichester	чичестер
chiclayo	чиклайо
chieti	кьети
chihuahua	чиуауа
chillán	чильян
chimay	шиме
chimborazo	чимборасо
chipset	чипсет
chloropsis	листовки
cholet	шоле
chorzów	хожув
christchurch	крайстчерч
christine	кристин
chávez	чавес
chōfu	тёфу
chūgoku	тюгоку
ciara	сиара
cibuti	джибути
cicero	цицерон
ciconia	аисты
cidde	джидда
cienciano	сьенсиано
cieszyn	цешин
cieza	сьеса
cihangir	джахангир
cihaz	устройство
cinas	каламбур
cinayet	убийство
cincinnati	цинциннати
cingulata	броненосцы
cirsium	бодяк
cissé	сиссе
cizvitler	иезуиты
clarence	кларенс
claudius	клавдий
clermont	клермон
cleveland	кливленд
clupea	сельди
cléo	клео
coahuila	коауила
coburg	кобург
cochabamba	кочабамба
cognomen	когномен
cohen	коэн
coimbra	коимбра
colchester	колчестер
colette	колетт
collie	колли
colmar	кольмар
colombes	коломб
colorado	колорадо
coluber	полозы
columbus	колумбус
commodus	коммод
compiègne	компьень
conceição	консейсан
concorde	конкорд
condom	кондом
condottieri	кондотьер
conegliano	конельяно
connacht	коннахт
connecticut	коннектикут
cooper	купер
copiapó	копьяпо
coppélia	коппелия
copán	копан
coquimbo	кокимбо
cork	корк
corleone	корлеоне
cornus	кизил
cornwall	корнуолл
coro	коро
corpus	корпус
corrientes	корриентес
corrèze	коррез
cortona	кортона
corvus	вороны
cosenza	козенца
cottbus	котбус
coturnix	перепела
coulomb	кулон
country	кантри
courtois	куртуа
coventry	ковентри
covilhã	ковильян
covo	ково
coğrafya	география
coşku	энтузиазм
crataegus	боярышник
crema	крема
cremona	кремона
criciúma	крисиума
crossover	кроссовер
crotone	кротоне
cthulhu	ктулху
cuci	джучи
cuenca	куэнка
cuiabá	куяба
cuma	пятница
cumartesi	суббота
cumhuriyet	республика
cundinamarca	кундинамарка
cuneo	кунео
cunta	хунта
cupid	купидон
curaçao	кюрасао
curicó	курико
curitiba	куритиба
cusco	куско
cuxhaven	куксхафен
cycas	саговник
częstochowa	ченстохова
cádiz	кадис
câlût	голиаф
cúcuta	кукута
cücelik	карлик
cüruf	шлак
cüzdan	кошелёк
cıva	ртуть
dadı	няня
daegu	тэгу
daejeon	тэджон
dafni	дафна
daimler	даймлер
daimyo	даймё
daire	круг
dakar	дакар
dakika	минута
dakka	дакка
dakota	дакота
dalgıçlık	дайвинг
dalian	далянь
dalit	неприкасаемые
dallas	даллас
dalmaçya	далмация
dalton	дальтон
dama	шашки
damak	нёбо
daman	даман
damla	капля
danae	даная
danaos	данай
dandong	даньдун
dandy	денди
daniell	даниэль
danlar	даны
dans	танец
dantel	кружево
danışmanlık	консалтинг
daqing	дацин
dara	дара
dargiler	даргинцы
darice	дари
darin	дарин
dark	дарк
darmstadt	дармштадт
dart	дартс
dasa	даса
dashi	даси
datong	датун
dauphiné	дофине
dave	дейв
davos	давос
davranış	поведение
davud	давид
davul	барабан
davulcu	барабанщик
dayanışma	солидарность
dayk	дайка
daçya	дакия
dağlık	нагорье
dağıstan	дагестан
daşoğuz	дашогуз
deathcore	дэткор
debrecen	дебрецен
decameron	декамерон
decatur	декейтер
dede	деде
dedikodu	сплетни
defin	погребение
defter	блокнот
dekatlon	десятиборье
dekor	декорация
delaware	делавэр
delfi	дельфы
delft	делфт
delgado	дельгадо
delhi	дели
delichon	воронки
delilik	сумасшествие
delirious	чокнутый
delon	делон
delta	дельта
demans	деменция
demeter	деметра
demir	железо
demmin	деммин
demokrasi	демократия
demokratikleşme	демократизация
demokritos	демокрит
demon	демон
denarius	денарий
dendermonde	дендермонде
deneme	эссе
denetim	аудит
deney	эксперимент
deniz	море
denizci	моряк
denizli	денизли
denklem	уравнение
denton	дентон
denver	денвер
departman	департамент
deprem	землетрясение
dera	даръа
derbyshire	дербишир
dere	ручей
dergi	журнал
deri	кожа
derleyici	компилятор
dermatit	дерматит
derviş	дервиш
desdemona	дездемона
desinatör	рисовальщик
dessau	дессау
destan	дастан
determinant	определитель
detmold	детмольд
detroit	детройт
detveyt	дедвейт
deve	верблюды
deventer	девентер
devi	деви
devlet	государство
devralma	поглощение
devrim	революция
devrimci	революционер
dewey	дьюи
deyim	идиома
dezhou	дэчжоу
değerlik	валентность
değirmen	мельница
değişken	переменная
dharma	дхарма
diadem	диадема
diaspora	диаспора
didgeridoo	диджериду
diekirch	дикирх
dielektrik	диэлектрик
dieppe	дьеп
digipak	диджипак
dijon	дижон
dikdörtgen	прямоугольник
dikilitaş	обелиск
dikkat	внимание
diktatör	диктатор
diktatörlük	диктатура
dilbilgisi	грамматика
dilbilim	лингвистика
dilekçe	петиция
dili	дили
dilican	дилижан
dimer	димер
dimitrovgrad	димитровград
dinamit	динамит
dindarlık	благочестие
dingo	динго
dingxi	динси
dino	дино
dinozor	динозавры
dinyester	днестр
diocletianus	диоклетиан
dionysos	дионис
diorama	диорама
diploma	диплом
diplomasi	дипломатия
diplomat	дипломат
dipçik	приклад
dirce	дирка
disk	диск
disko	диско
diskografi	дискография
diskotek	дискотека
disneyland	диснейленд
displazi	дисплазия
diss	дисс
distopya	антиутопия
diva	дива
diverjans	дивергенция
divin	двин
diyafram	диафрагма
diyagram	диаграмма
diyakoz	диакон
diyalektik	диалектика
diyalektoloji	диалектология
diyalog	диалог
diyanet	религиозность
diyarbakır	диярбакыр
diyaspor	диаспор
diyetisyen	диетолог
diyojen	диоген
diyot	диод
dize	стих
dizi	последовательность
dişi	самка
dmanisi	дманиси
dmitrov	дмитров
doboj	добой
dobriç	добрич
dobruca	добруджа
dogmatizm	догмат
doha	доха
dojo	додзё
doktrin	доктрина
dokuma	ткачество
dolandırıcılık	мошенничество
dolar	доллар
dolmen	дольмен
dolu	град
dolunay	полнолуние
domain	домен
dominika	доминика
dominyon	доминион
domitia	домиция
domitianus	домициан
domuz	кабаны
donatello	донателло
donbas	донбасс
doncaster	донкастер
dondurma	мороженое
donetsk	донецк
dongguan	дунгуань
donut	пончик
dopamin	дофамин
doping	допинг
dora	дора
dordogne	дордонь
dordrecht	дордрехт
dorset	дорсет
dortmund	дортмунд
dover	дувр
downtempo	даунтемпо
downtown	даунтаун
doxa	докса
doçent	доцент
doğa	природа
doğan	соколы
doğaçlama	импровизация
doğaüstü	сверхъестественное
doğrultucu	выпрямитель
doğu	восток
doğum	рождение
dragaş	драгаш
dramaturji	драматургия
drammen	драммен
drancy	дранси
draupadi	драупади
drava	драва
drenaj	дренаж
drenthe	дренте
drift	дрейф
drin	дрин
drina	дрина
drogheda	дроэда
drosophila	дрозофилы
drow	дроу
drupa	костянка
druskininkai	друскининкай
dubai	дубай
dublin	дублин
dubno	дубно
dubrovnik	дубровник
dubstep	дабстеп
dudak	губы
dudelange	дюделанж
duisburg	дуйсбург
duka	дукат
duma	дума
dundas	дандас
dunedin	данидин
dungan	дунган
dunkerque	дюнкерк
dupnitsa	дупница
dura	дура
duran	дуран
durban	дурбан
durga	дурга
durham	дарем
duvar	стена
duygu	эмоция
duygudurum	настроение
duyu	ощущение
duşanbe	душанбе
dzogchen	дзогчен
döfen	дофин
dönence	тропики
dönme	вращение
dörtgen	четырёхугольник
döviz	валюта
düden	понор
düdük	свисток
düello	дуэль
düet	дуэт
dükalık	герцогство
dünya	земля
dürbün	бинокль
düren	дюрен
dürüstlük	честность
düsseldorf	дюссельдорф
düzine	дюжина
düzlem	плоскость
düğme	пуговица
düğüm	узел
düşman	враг
düşmanlık	враждебность
düşük	выкидыш
děčín	дечин
dıraç	дуррес
dışavurumculuk	экспрессионизм
ebelik	акушерство
eberswalde	эберсвальде
ebeveyn	родители
eboli	эболи
ebro	эбро
ecchi	этти
echinodermata	иглокожие
echternach	эхтернах
eczacılık	фармация
edebiyat	литература
edessa	эдесса
edirne	эдирне
edison	эдисон
edmonton	эдмонтон
edmundo	эдмундо
edson	эдсон
eflak	валахия
efron	эфрон
efsane	легенда
egaleo	эгалео
egemenlik	суверенитет
egoizm	эгоизм
ehrlich	эрлих
eibar	эйбар
eichstätt	айхштетт
eifel	айфель
eiji	эйдзи
eilat	эйлат
eindhoven	эйндховен
eisenach	эйзенах
eisenstadt	айзенштадт
ejderha	дракон
ekberiyet	майорат
ekibastuz	экибастуз
ekim	октябрь
ekinoks	равноденствие
eklem	сустав
eklenti	плагин
ekmek	хлеб
ekoloji	экология
ekonomi	экономика
ekonomist	экономист
ekosistem	экосистема
eksarh	экзарх
ekselans	превосходительство
ekskavatör	экскаватор
ekstraksiyon	экстракция
ekvador	эквадор
ekvator	экватор
elam	элам
elazığ	элязыг
elbasan	эльбасан
elbise	платье
elbląg	эльблонг
elche	эльче
eldiven	перчатки
electro	электро
elektra	электра
elektrifikasyon	электрификация
elektrik	электричество
elektroliz	электролиз
elektromekanik	электромеханика
elektropop	электропоп
elektrostal	электросталь
elektrot	электрод
elektörlük	курфюрст
eleme	сито
elementary	элементарно
eleştiri	критика
elipsoit	эллипсоид
elista	элиста
elma	яблоко
elmas	алмаз
elmet	альметьевск
elyesa	елисей
embriyo	эмбрион
embriyoloji	эмбриология
emden	эмден
emek	труд
emerson	эмерсон
eminem	эминем
emirlik	эмират
emlak	недвижимость
emma	эмма
emperyalizm	империализм
empoli	эмполи
emzik	соска
ender	эндер
endonezya	индонезия
enerji	энергия
enflasyon	инфляция
engellilik	инвалидность
enguri	ингури
enjeksiyon	инъекция
enlem	широта
enna	энна
enoshima	эносима
enschede	энсхеде
ense	затылок
ensefalit	энцефалит
entalpi	энтальпия
entebbe	энтеббе
entelektüel	интеллектуал
entelijansiya	интеллигенция
entomoloji	энтомология
entourage	красавцы
entropi	энтропия
enugu	энугу
envigado	энвигадо
enzim	ферменты
eosen	эоцен
epidemi	эпидемия
epidemiyoloji	эпидемиология
epidermis	эпидермис
epifit	эпифиты
epigraf	эпиграф
epilepsi	эпилепсия
epilog	эпилог
epir	эпир
epistemoloji	эпистемология
epizot	эпизод
eponim	эпоним
epsilon	эпсилон
erato	эрато
erbil	эрбиль
erdebil	ардебиль
erdel	трансильвания
erdem	добродетель
erfurt	эрфурт
ericaceae	вересковые
eriha	иерихон
eril	самец
erime	плавление
eritre	эритрея
erivan	ереван
erkek	мужчина
erlangen	эрланген
ermeniler	армяне
ermenistan	армения
ernest	эрнест
eroin	героин
erotik	эротика
erozyon	эрозия
erzincan	эрзинджан
esbjerg	эсбьерг
eshilos	эсхил
esin	вдохновение
eskilstuna	эскильстуна
eskiz	эскиз
eskişehir	эскишехир
eskişehirspor	эскишехирспор
eskort	эскорт
eskrim	фехтование
eskudo	эскудо
esneklik	упругость
esperantist	эсперантист
espinho	эшпинью
espoo	эспоо
espresso	эспрессо
esrar	марихуана
essen	эссен
essex	эссекс
estergon	эстергом
estonya	эстония
estoril	эшторил
estrada	эстрада
etalon	эталон
etan	этан
etana	этана
etanol	этанол
etek	юбка
etik	этика
etilen	этилен
etiyopya	эфиопия
etnografya	этнография
etoburlar	плотоядные
etrüskler	этруски
etçiller	хищные
eupen	эйпен
euphorbiaceae	молочайные
eureka	эврика
euripides	еврипид
euro	евро
eurocup	еврокубок
eurodans	евродэнс
evenkiler	эвенки
evenler	эвены
everglades	эверглейдс
everton	эвертон
evren	вселенная
evrengzib	аурангзеб
evrensel	всеобщее
evrim	эволюция
exeter	эксетер
extremadura	эстремадура
eyer	седло
eylül	сентябрь
eyvan	айван
ezgi	мелодия
ezop	эзоп
eğil	эгиль
eğitim	образование
eğlence	развлечение
eğrelti	папоротники
eğri	кривая
eğriboz	эвбея
eğrilik	кривизна
eşanlamlı	синонимы
eşcinsellik	гомосексуальность
eşitsizlikler	неравенство
fabiana	фабиана
fabl	басня
faboideae	мотыльковые
fabrika	фабрика
fado	фаду
faenza	фаэнца
faetano	фаэтано
fagaceae	буковые
fagositoz	фагоцитоз
fagot	фагот
faks	факс
faktöriyel	факториал
falun	фалун
familya	семейство
fanatiklik	фанатизм
fantezi	фэнтези
fantoma	фантомас
faraday	фарадей
fargo	фарго
farmakoloji	фармакология
farslar	персы
fasces	фасции
fatih	фатих
fauna	фауна
fayans	фаянс
faysalabad	фейсалабад
faşizm	фашизм
federalizm	федерализм
feldmareşal	фельдмаршал
feldwebel	фельдфебель
felipe	фелипе
felix	феликс
felsefe	философия
felç	паралич
feminizm	феминизм
fena	фана
fenerbahçe	фенербахче
feniks	феникс
fenol	фенол
fenoller	фенолы
fenomen	феномен
fenomenoloji	феноменология
fenotip	фенотип
feodalizm	феодализм
fergana	фергана
feribot	паром
fermantasyon	брожение
fermo	фермо
fernandes	фернандеш
fernández	фернандес
feromon	феромоны
fesa	феса
festival	фестиваль
festuca	овсяница
feta	фета
fetret	междуцарствие
feyenoord	фейеноорд
fianarantsoa	фианаранцуа
fidelio	фиделио
fier	фиери
fiesole	фьезоле
fife	файф
figueres	фигерас
fiil	глагол
fiji	фиджи
filai	филы
filateli	филателия
filibe	пловдив
filinta	флейт
filipinler	филиппины
filippi	филиппы
filistin	палестина
filistinliler	палестинцы
film	фильм
filo	флот
filoloji	филология
filozof	философ
finans	финансы
fincan	кубок
fines	финес
finlandiya	финляндия
finler	финны
finn	финн
finnmark	финнмарк
fiorentino	фьорентино
firavun	фараон
firdevsî	фирдоуси
fitness	фитнес
fitoplankton	фитопланктон
fiyat	цена
fizik	физика
fizikçi	физик
fizyoloji	физиология
fizyoterapist	физиотерапевт
flamanlar	фламандцы
flamenko	фламенко
flamingo	фламинго
flensburg	фленсбург
flevoland	флеволанд
flok	кливер
flor	фтор
floransa	флоренция
florianópolis	флорианополис
florida	флорида
florin	флорин
florina	флорина
flotilla	флотилия
flüt	флейта
fobi	фобия
foggia	фоджа
foligno	фолиньо
folklor	фольклор
fomalhaut	фомальгаут
fonda	фонда
fonlama	финансирование
fontainebleau	фонтенбло
forbach	форбак
forcalquier	форкалькье
forchheim	форххайм
forli	форли
formaldehit	формальдегид
fortaleza	форталеза
fortran	фортран
forum	форум
fosfat	фосфаты
fosfolipit	фосфолипиды
fosfor	фосфор
fossa	фосса
fotometri	фотометрия
foton	фотон
fotosentez	фотосинтез
fotoğrafçı	фотограф
fotoğrafçılık	фотография
fourier	фурье
fraga	фрага
frak	фрак
fram	фрам
franco	франко
frank	фрэнк
franklar	франки
franklin	франклин
frankofon	франкофоны
frankonya	франкония
fransa	франция
fransiskenler	францисканцы
fransızlar	французы
frança	франса
frascati	фраскати
frashëri	фрашери
fredrikstad	фредрикстад
freetown	фритаун
freguesia	фрегезия
freising	фрайзинг
frekans	частота
frengi	сифилис
fresk	фреска
freyja	фрейя
friedrichshafen	фридрихсхафен
friedrichstadt	фридрихштадт
frigg	фригг
frisch	фриш
frizler	фризы
frosinone	фрозиноне
fruktoz	фруктоза
fuar	ярмарка
fuat	фуад
fuhuş	проституция
fujian	фуцзянь
fukuoka	фукуока
fulda	фульда
fulton	фултон
fulvia	фульвия
funchal	фуншал
funk	фанк
fushun	фушунь
futbol	футбол
futurama	футурама
fuzhou	фучжоу
fuzûlî	физули
fötr	федора
führer	фюрер
füniküler	фуникулёр
fünye	детонатор
fürth	фюрт
füssen	фюссен
fütürizm	футуризм
fıkra	шутка
fıkıh	фикх
fındık	лещина
fırat	евфрат
fırkateyn	фрегат
fırın	печь
fırıncı	пекарь
fıçı	бочка
gabon	габон
gaborone	габороне
gabro	габбро
gaeta	гаэта
gaga	клюв
gagavuzlar	гагаузы
gagavuzya	гагаузия
gagra	гагра
gala	премьера
galaksi	галактика
galanthus	подснежник
galata	галата
galatea	галатея
galba	гальба
galen	гален
galerius	галерий
galler	уэльс
gallienus	галлиен
galliler	валлийцы
galway	голуэй
galya	галлия
galyum	галлий
gambit	гамбит
gambiya	гамбия
game	гейм
gana	гана
gandalf	гэндальф
ganeşa	ганеша
gangster	гангстер
garaj	гараж
gari	гари
gariplik	странность
garnitür	гарнир
garnizon	гарнизон
garo	гаро
garoua	гаруа
garson	официант
garuda	гаруда
gaskonya	гасконь
gata	гата
gatineau	гатино
gatçina	гатчина
gaucho	гаучо
gauleiter	гауляйтер
gauss	гаусс
gauteng	гаутенг
gayzer	гейзер
gazete	газета
gazeteci	журналист
gazetecilik	журналистика
gaziantep	газиантеп
gaziantepspor	газиантепспор
gazimağusa	фамагуста
gazne	газни
gazprom	газпром
gazze	газа
gdańsk	гданьск
gdynia	гдыня
gece	ночь
gediminas	гедимин
gekkonidae	гекконы
gelderland	гелдерланд
geldern	гельдерн
gelecek	будущее
gelencik	геленджик
gelenek	традиция
gelfand	гельфанд
gelin	невеста
gelir	доход
gelsenkirchen	гельзенкирхен
gematria	гематрия
gembloux	жамблу
gemi	судно
genelge	циркуляр
general	генерал
generalissimo	генералиссимус
genesis	генезис
genetik	генетика
genk	генк
genlik	амплитуда
genom	геном
genotip	генотип
gent	гент
gençlik	молодёжь
geometri	геометрия
george	джордж
georgia	джорджия
gerekçe	разум
germanicus	германик
germanyum	германий
gero	геро
gerçek	истина
gerçeklik	реальность
gerçeküstücülük	сюрреализм
gestapo	гестапо
getafe	хетафе
getto	гетто
geyşa	гейша
gezegen	планета
gezi	экскурсия
ghedi	геди
giessen	гисен
gigabayt	гигабайт
gigant	гиганты
gilgit	гилгит
gine	гвинея
ginza	гиндза
giorgione	джорджоне
giri	гири
girit	крит
girişimci	предприниматель
girişimcilik	предпринимательство
girona	жирона
gironde	жиронда
giselle	жизель
gitar	гитара
giyim	одежда
giyotin	гильотина
glarus	гларус
glasgow	глазго
glasnost	гласность
glastonbury	гластонбери
glazov	глазов
glendale	глендейл
glikozit	гликозиды
gliridae	соневые
gliseraldehit	глицеральдегид
gliserin	глицерин
glisin	глицин
gliwice	гливице
glokom	глаукома
gloria	глория
gloucester	глостер
gloucestershire	глостершир
glukoz	глюкоза
gmina	гмина
gniezno	гнезно
godzilla	годзилла
goiás	гояс
goiânia	гояния
gold	голд
goldberg	гольдберг
goldman	голдман
goldsmith	голдсмит
goldstein	гольдштейн
golem	голем
golf	гольф
goma	гома
gondomar	гондомар
gong	гонг
goodman	гудман
gorajde	горажде
gord	городище
gordes	горд
gordian	гордиан
gorgonlar	горгоны
gori	гори
goril	гориллы
goris	горис
gorizia	гориция
gorlice	горлице
gorodets	городец
goslar	гослар
gospić	госпич
gostivar	гостивар
gotha	гота
gotland	готланд
gotlar	готы
gouda	гауда
gozo	гоцо
graben	грабен
gradyan	градиент
grafen	графен
grafik	графика
grafit	графит
grain	гран
gram	грамм
granada	гранада
granit	гранит
granja	гранжа
granollers	гранольерс
grappa	граппа
grasse	грас
gratianus	грациан
gravür	офорт
graz	грац
graziani	грациани
greenpeace	гринпис
gregoria	григория
greifswald	грайфсвальд
gremlinler	гремлины
grenada	гренада
grenoble	гренобль
grev	забастовка
grevenmacher	гревенмахер
grindcore	грайндкор
grip	грипп
grodno	гродно
groningen	гронинген
grotesk	гротеск
grotto	грот
grozni	грозный
gruber	грубер
grudziądz	грудзёндз
grunge	гранж
grünberg	грюнберг
guadalajara	гвадалахара
guadalcanal	гуадалканал
guadalquivir	гвадалквивир
guadeloupe	гваделупа
guaj	гуашь
guam	гуам
guan	гуань
guanako	гуанако
guangdong	гуандун
guangzhou	гуанчжоу
guano	гуано
guarda	гуарда
guardiola	гвардиола
guastalla	гвасталла
guayaquil	гуаякиль
gubbio	губбио
guben	губен
guberniya	губерния
gudauta	гудаута
guernica	герника
guerrero	герреро
gufi	гуфи
guggenheim	гуггенхайм
guildford	гилфорд
guilherme	гильерме
guimarães	гимарайнш
guingamp	генган
guinness	гиннесс
guiyang	гуйян
guizhou	гуйчжоу
gulca	кульджа
gulu	гулу
gumi	куми
gummersbach	гуммерсбах
gunzenhausen	гунценхаузен
guria	гурия
gurmukhi	гурмукхи
guru	гуру
gurur	гордость
gurzuf	гурзуф
guthrie	гатри
guwahati	гувахати
guyanalar	гвиана
gwangju	кванджу
gyeonggi	кёнгидо
gyeongju	кёнджу
gyps	грифы
győr	дьёр
gänserndorf	гензерндорф
gävle	евле
gökdelen	небоскрёб
gökkuşağı	радуга
göknar	пихта
gölet	пруд
gölge	тень
gömlek	рубашка
gönderme	аллюзия
göppingen	гёппинген
görgü	этикет
görice	корча
görlitz	гёрлиц
görüşme	собрание
göstergebilim	семиотика
götaland	гёталанд
göteborg	гётеборг
göttingen	гёттинген
gözaltı	задержание
gözlemevi	обсерватория
gözleve	евпатория
gözlük	очки
gözyaşı	слеза
göçebelik	кочевники
gübre	удобрения
güdü	мотивация
gülmek	смех
gümrü	гюмри
gümrük	таможня
gümüş	серебро
günah	грех
günberi	перигелий
gündönümü	солнцестояние
gündüz	день
güneş	солнце
güneşlik	жалюзи
günlük	дневник
gürcistan	грузия
gürcüler	грузины
güreş	борьба
gürgan	горган
gürgen	граб
gütersloh	гютерсло
güve	моли
güvercinlik	голубятня
güverte	палуба
gıda	пища
gılgamış	гильгамеш
gırtlak	гортань
głogów	глогув
haapsalu	хаапсалу
habarovsk	хабаровск
haber	новости
habil	авель
habip	хабиб
habis	злое
habitat	местообитание
hachiōji	хатиодзи
hacim	объём
hacker	хакер
hackney	хакни
hadi	хади
hadis	хадис
hadrianus	адриан
hadım	евнух
hafnarfjörður	хабнарфьордюр
hafta	неделя
haganah	хагана
hagen	хаген
haham	раввин
haikou	хайкоу
haiku	хайку
hainan	хайнань
haiphong	хайфон
hakaslar	хакасы
hakasya	хакасия
hakim	хаким
halat	трос
halep	алеппо
halk	народ
halkidiki	халкидики
halle	галле
haller	халлер
halley	галлей
halonen	халонен
halı	ковёр
hama	хама
hamam	хаммам
hamamatsu	хамамацу
hamburg	гамбург
hamburger	гамбургер
hamidiye	хамидие
hamilton	гамильтон
hamina	хамина
hamlet	гамлет
hamm	хамм
hammersmith	хаммерсмит
hammurabi	хаммурапи
hampshire	гэмпшир
hamster	хомяки
hamur	тесто
hamza	хамза
hanau	ханау
hanedan	династия
hanehalkı	домохозяйство
hanende	ханенде
hang	ханг
hangar	ангар
hangzhou	ханчжоу
hangıl	хангыль
hankendi	степанакерт
hankou	ханькоу
hannibal	ганнибал
hannover	ганновер
hanoi	ханой
hanshu	ханьшу
hanya	ханья
hanzhong	ханьчжун
hançer	кинжал
haplogrup	гаплогруппы
harabe	руины
haram	харам
harare	хараре
harbin	харбин
hardcore	хардкор
harding	хардинг
harem	гарем
harezm	хорезм
harf	буква
harkiv	харьков
harlow	харлоу
harman	харман
hartford	хартфорд
hartum	хартум
harun	харун
harvey	харви
haryana	харьяна
hasan	хасан
hasavyurt	хасавюрт
haski	хаски
hasta	пациент
hastalık	болезнь
hastane	больница
hastings	гастингс
hatchback	хэтчбек
hathor	хатхор
hatip	оратор
hattuşili	хаттусили
hatşepsut	хатшепсут
haugesund	хёугесунн
haumea	хаумеа
hava	воздух
havaalanı	аэропорт
havacılık	авиация
havan	мортира
havana	гавана
havari	апостолы
havayolu	авиакомпания
havel	хафель
haven	хейвен
havlu	полотенце
hawaii	гавайи
hawkins	хокинс
hayalet	привидение
haydarabad	хайдарабад
hayek	хайек
hayfa	хайфа
hayvan	животные
hayvancılık	животноводство
hazarlar	хазары
hazine	клад
haçkar	хачкар
hebei	хэбэй
hece	слог
hedera	плющ
hedmark	хедмарк
heemskerk	хемскерк
hefei	хэфэй
hegang	хэган
hegemonya	гегемония
heidelberg	гейдельберг
heihe	хэйхэ
heilbronn	хайльбронн
heilongjiang	хэйлунцзян
heinsberg	хайнсберг
hekabe	гекуба
hektar	гектар
hektor	гектор
helena	хелена
helgoland	гельголанд
helianthus	подсолнечник
helikopter	вертолёт
helin	хелин
helios	гелиос
helmond	хелмонд
helsingborg	хельсингборг
helsinki	хельсинки
helyum	гелий
hematit	гематит
hemedan	хамадан
hemoglobin	гемоглобин
henan	хэнань
hengelo	хенгело
hentai	хентай
hentbol	гандбол
hepatit	гепатит
heptatlon	семиборье
hera	гера
heraclea	гераклея
herakles	геракл
herbaryum	гербарий
hereford	херефорд
herefordshire	херефордшир
hererolar	гереро
herford	херфорд
hergé	эрже
hermes	гермес
hermosillo	эрмосильо
herning	хернинг
herodot	геродот
hersek	герцеговина
herson	херсон
hertfordshire	хартфордшир
herzberg	херцберг
hessen	гессен
hetman	гетман
hevi	хеви
heyelan	оползень
heykel	скульптура
heze	хэцзэ
hezekiel	иезекииль
hibe	грант
hibiscus	гибискус
hibritleşme	гибридизация
hicaz	хиджаз
hidroelektrik	гидроэнергетика
hidrografya	гидрография
hidrojen	водород
hidrojenasyon	гидрирование
hidrokarbon	углеводороды
hidrolik	гидравлика
hidroliz	гидролиз
hiiumaa	хийумаа
hijyen	гигиена
hikari	хикари
hikâye	рассказ
hilal	полумесяц
hildburghausen	хильдбургхаузен
hildesheim	хильдесхайм
hilton	хилтон
hilâfet	халифат
himaye	протекторат
himiko	химико
himki	химки
hindi	индейки
hindiçin	индокитай
hinduizm	индуизм
hindustânî	хиндустани
hintçe	хинди
hipermarket	гипермаркет
hiperplazi	гиперплазия
hipertrofi	гипертрофия
hipnoz	гипноз
hipodrom	ипподром
hipokrat	гиппократ
hipotalamus	гипоталамус
hipparkos	гиппарх
hippi	хиппи
hippolyte	ипполита
hippopotamus	бегемоты
hiratsuka	хирацука
hirohito	хирохито
hirosaki	хиросаки
hissedar	акционер
histamin	гистамин
histoloji	гистология
hiyerarşi	иерархия
hiyeroglif	иероглиф
hizmetçi	горничная
hiçlik	ничто
hobart	хобарт
hobi	хобби
hocalı	ходжалы
hodangiller	бурачниковые
hoffman	гофман
hogwarts	хогвартс
hokand	коканд
hokkaidō	хоккайдо
holden	холден
holi	холи
hollanda	нидерланды
hollandalılar	голландцы
hollywood	голливуд
holmsk	холмск
holokost	холокост
holosen	голоцен
homyel	гомель
honduras	гондурас
honfleur	онфлёр
honi	хони
honiara	хониара
honka	хонка
honolulu	гонолулу
honorius	гонорий
honshū	хонсю
hopa	хопа
hoparlör	громкоговоритель
hopdediks	обеликс
horatius	гораций
hordaland	хордаланн
hordeum	ячмень
horlivka	горловка
hormon	гормоны
horoz	петух
horsens	хорсенс
horváth	хорват
hostel	хостел
hostes	стюардесса
hotin	хотин
houston	хьюстон
hristiyan	христианин
hristiyanlık	христианство
hsinchu	синьчжу
huancayo	уанкайо
hubble	хаббл
hubei	хубэй
huber	хубер
hububat	зерно
hucend	худжанд
huddersfield	хаддерсфилд
hudson	хадсон
huelva	уэльва
huesca	уэска
hughes	хьюз
huguenotlar	гугеноты
hukuk	право
hukukçu	юрист
hulahup	обруч
huli	хули
hulûl	воплощение
humboldt	гумбольдт
humenné	гуменне
hunan	хунань
hunedoara	хунедоара
hunlar	гунны
huntingdon	хантингдон
huntington	хантингтон
hurda	металлолом
huri	гурии
hussitler	гуситы
hustle	виртуозы
hutchinson	хатчинсон
huánuco	уануко
hvar	хвар
hylidae	квакши
hyperion	гиперион
hyuna	хёна
hyvinkää	хювинкяа
hâle	гало
häme	хяме
hämeenlinna	хямеэнлинна
hücre	клетка
hükûmet	правительство
hüküm	приговор
hükümdar	монарх
hükümlü	осуждённый
hümanizm	гуманизм
hırvatistan	хорватия
hırvatlar	хорваты
hıtaylar	кидани
ijsselmeer	эйсселмер
idaho	айдахо
iizuka	иидзука
ilex	падуб
illinois	иллинойс
ilmenau	ильменау
imatra	иматра
imola	имола
imperium	империй
inara	инара
indiana	индиана
indianapolis	индианаполис
indra	индра
ingolstadt	ингольштадт
innsbruck	инсбрук
inowrocław	иновроцлав
interkosmos	интеркосмос
interpol	интерпол
inti	инти
inverness	инвернесс
inđija	инджия
iowa	айова
ipanema	ипанема
iquique	икике
irak	ирак
iraklılar	иракцы
irapuato	ирапуато
irena	ирены
irgun	иргун
iridaceae	ирисовые
irkçılık	расизм
irun	ирун
irving	ирвинг
isernia	изерния
istırap	тоска
isık	есик
isırgan	крапива
isırık	укус
isıtma	отопление
iwakuni	ивакуни
işık	свет
işıldama	люминесценция
jackson	джексон
jacksonville	джэксонвилл
jaguar	ягуар
jaipur	джайпур
jajce	яйце
jako	жако
jalisco	халиско
jamaika	ямайка
jambon	ветчина
jamestown	джеймстаун
janssen	янссен
japonlar	японцы
japonya	япония
jargon	жаргон
jartiyer	подвязки
jarvis	джарвис
jaworzno	явожно
jaén	хаэн
jeanette	жанетт
jeju	чеджудо
jelatin	желатин
jelgava	елгава
jeodezi	геодезия
jeofizik	геофизика
jeokimya	геохимия
jeoloji	геология
jeomorfoloji	геоморфология
jeopolitik	геополитика
jerome	жером
jest	жест
jewel	джуэл
jezkazgan	жезказган
jiamusi	цзямусы
jiangsu	цзянсу
jigolo	жиголо
jigulevsk	жигулёвск
jihlava	йиглава
jilin	гирин
jimnastik	гимнастика
jinan	цзинань
jinekoloji	гинекология
jingzhou	цзинчжоу
jining	цзинин
jinzhong	цзиньчжун
jinzhou	цзиньчжоу
jiroskop	гироскоп
jixi	цзиси
jičín	йичин
joensuu	йоэнсуу
joey	джоуи
johannesburg	йоханнесбург
johnson	джонсон
johnston	джонстон
joinville	жуанвиль
jokey	жокей
jones	джонс
joseon	чосон
juche	чучхе
judo	дзюдо
juglandaceae	ореховые
julie	джули
jundiaí	жундиаи
juneau	джуно
justin	юстин
jutsu	дзюцу
jyväskylä	йювяскюля
jöle	желе
jönköping	йёнчёпинг
jülich	юлих
jüpiter	юпитер
jūrmala	юрмала
kabakgiller	тыквенные
kabala	каббала
kabardeyler	кабардинцы
kabare	кабаре
kablo	кабель
kabuk	шелл
kabuki	кабуки
kabuklular	ракообразные
kabul	принятие
kaburga	ребро
kabwe	кабве
kadastro	кадастр
kadeh	потир
kader	судьба
kadife	бархат
kadima	кадима
kadir	кадир
kadraj	видоискатель
kaduna	кадуна
kadı	кади
kadın	женщина
kadırga	галера
kafa	голова
kafe	кафе
kafein	кофеин
kafiye	рифма
kafkasya	кавказ
kaftan	кафтан
kaheti	кахетия
kahire	каир
kahramanmaraş	кахраманмараш
kahvaltı	завтрак
kahve	кофе
kaide	пьедестал
kaim	каим
kaiserslautern	кайзерслаутерн
kajaani	каяани
kaju	кешью
kakadu	какаду
kakao	какао
kaktüsgiller	кактусовые
kaká	кака
kakım	горностай
kalamar	кальмары
kalamata	каламата
kalay	олово
kalaşnikov	калашников
kaldera	кальдера
kale	крепость
kaleb	калеб
kaleci	вратарь
kaledonya	каледония
kalemişi	гравировка
kalevala	калевала
kali	кали
kalibrasyon	калибровка
kalibre	калибр
kaliforniya	калифорния
kaligrafi	каллиграфия
kaliningrad	калининград
kalinka	калинка
kalipso	калипсо
kalisz	калиш
kaliya	калия
kalküta	калькутта
kalliope	каллиопа
kalmukya	калмыкия
kalp	сердце
kalsit	кальцит
kalsiyum	кальций
kaluga	калуга
kalvinizm	кальвинизм
kalyon	галеон
kamakura	камакура
kamboçya	камбоджа
kamelya	камелия
kamen	камен
kamenev	каменев
kameraman	кинооператор
kameriye	беседка
kamerun	камерун
kamikaze	камикадзе
kampala	кампала
kamuflaj	камуфляж
kamışin	камышин
kanada	канада
kanalizasyon	канализация
kanama	кровотечение
kanatçık	элероны
kanazawa	канадзава
kanaş	канаш
kandehar	кандагар
kandela	кандела
kandiye	ираклион
kanepe	диван
kanguru	кенгуру
kangxi	канси
kaniş	пудель
kanji	кандзи
kano	каноэ
kanpur	канпур
kansai	кансай
kansas	канзас
kansk	канск
kansu	ганьсу
kansızlık	анемия
kantat	кантата
kantele	кантеле
kanvas	холст
kanye	канье
kanyon	каньон
kaohsiung	гаосюн
kaolin	каолин
kapadokya	каппадокия
kapan	ловушка
kapelle	капелле
kapitalizm	капитализм
kaplan	тигр
kaplumbağa	черепахи
kapı	дверь
kara	кара
karabağ	карабах
karabulak	карабулак
karaciğer	печень
karadağ	черногория
karakalpakistan	каракалпакстан
karakatau	кракатау
karakol	караколь
karamel	карамель
karanlık	темнота
karantina	карантин
karaoke	караоке
kararname	декрет
karate	карате
karavel	каравелла
karaylar	караимы
karaçaylar	карачаевцы
karaçi	карачи
karağandı	караганда
karbon	углерод
karbonat	карбонаты
karbonhidrat	углеводы
karbüratör	карбюратор
kardinal	кардинал
kardiyoloji	кардиология
kardiçe	кардица
kare	квадрат
karekin	гарегин
karikatür	карикатура
karine	презумпция
karintiya	каринтия
kariyer	карьера
karlovac	карловац
karlskrona	карлскруна
karlsruhe	карлсруэ
karlstad	карлстад
karma	карма
karmana	кармана
karmaşıklık	сложность
karnataka	карнатака
karnaval	карнавал
karnobat	карнобат
karoo	кару
karoser	кузов
karoten	каротин
karotenoid	каротиноиды
karpatlar	карпаты
karpuz	арбуз
kars	карс
karsak	корсак
karst	карст
kart	кард
kartal	орлиные
kartalı	карталы
kartel	картель
karting	картинг
kartli	картли
kartografya	картография
karuizawa	каруидзава
karya	кария
karyotip	кариотип
karı	жена
karın	живот
karınca	муравьи
kasan	касан
kasap	мясник
kashiwa	касива
kasiyer	кассир
kask	каска
kasket	шапка
kasko	каско
kaspiysk	каспийск
kassandra	кассандра
kassel	кассель
kastamonu	кастамону
kastilya	кастилия
kasuga	касуга
kasımpatı	хризантема
kasır	особняк
kata	ката
katakomb	катакомбы
katal	катал
katalanlar	каталонцы
kataliz	катализ
katalonya	каталония
katamaran	катамаран
katana	катана
katanya	катания
katar	катар
kate	кате
kateter	катетер
katholikon	кафоликон
katliam	резня
katmandu	катманду
katolikos	католикос
katot	катод
katowice	катовице
katran	дёготь
katsayı	коэффициент
kattegat	каттегат
katyon	катион
katyuşa	катюша
kauai	кауаи
kaunas	каунас
kavak	тополь
kavala	кавала
kavanoz	банка
kavrama	понимание
kavun	дыня
kawagoe	кавагоэ
kawasaki	кавасаки
kaynakçı	сварщик
kaynar	кайнар
kayrevan	кайруан
kayseri	кайсери
kayserispor	кайсериспор
kayyım	опекун
kazmunaygaz	казмунайгаз
kaza	авария
kazablanka	касабланка
kazah	газах
kazak	казак
kazakfilm	казахфильм
kazakhmys	казахмыс
kazakistan	казахстан
kazanlık	казанлык
kazoku	кадзоку
kazvin	казвин
kazvinî	казвини
kaçakçılık	контрабанда
kağan	каган
kağanlık	ханство
kaşgar	кашгар
kaşin	кашин
kaşira	кашира
kaşık	ложка
kebele	габала
kedah	кедах
kedi	кошка
kedigiller	кошачьи
kefal	лобан
kefalet	поручительство
kefalonya	кефалиния
kefe	феодосия
kefen	саван
keflavík	кеблавик
kehl	кель
kehribar	янтарь
keila	кейла
kekik	тимьян
kelantan	келантан
kelepçe	наручники
kelime	слово
keliser	хелицеры
keller	келлер
kellogg	келлог
keltler	кельты
kelvin	кельвин
kelâm	калам
kemal	кемаль
keman	скрипка
keme	крысы
kemerovo	кемерово
kemi	кеми
kemik	кость
kemin	кемин
kenan	ханаан
kendo	кэндо
kenevir	конопля
kenjutsu	кэндзюцу
kensington	кенсингтон
kentaur	кентавр
kentleşme	урбанизация
kentucky	кентукки
kenya	кения
kerala	керала
kerec	кередж
kerkenez	пустельга
kerkük	киркук
kerosen	керосин
kertenkele	ящерицы
kervan	караван
kerç	керчь
keseliler	сумчатые
kesriye	кастория
kestane	каштан
ketler	кеты
keton	кетоны
ketta	кветта
ketçap	кетчуп
keçe	войлок
keçuva	кечуа
keşiş	монах
keşmir	кашмир
kharoon	харон
khronos	хронос
khulna	кхулна
kibbutz	кибуц
kielce	кельце
kiev	киев
kigali	кигали
kiki	кики
kikinda	кикинда
kili	килия
kilikya	киликия
kilobayt	килобайт
kilogram	килограмм
kilometre	километр
kimera	химера
kimon	кимон
kimono	кимоно
kinaz	киназы
kinder	киндер
kinematik	кинематика
kingisepp	кингисепп
kingston	кингстон
kingu	кингу
kinin	хинин
kiralama	аренда
kirchner	кирхнер
kiremit	черепица
kiribati	кирибати
kirilenko	кириленко
kirishima	кирисима
kirişi	кириши
kirkenes	киркенес
kirmen	веретено
kirpik	ресницы
kirs	кирс
kirsanov	кирсанов
kiruna	кируна
kiryū	кирю
kisangani	кисангани
kislovodsk	кисловодск
kist	киста
kisumu	кисуму
kitap	книга
kitle	толпа
kitzbühel	кицбюэль
kizlyar	кизляр
kişi	личность
kişilik	индивидуальность
kişinev	кишинёв
kişniş	кориандр
klad	клада
kladno	кладно
kladogram	кладограмма
klaipėda	клайпеда
klarceti	кларджети
klarnet	кларнет
klasisizm	классицизм
klass	класс
klavsen	клавесин
kleve	клеве
klina	клина
klitoris	клитор
klon	клон
klor	хлор
klorofil	хлорофилл
kloroplast	хлоропласты
klosterneuburg	клостернойбург
kloten	клотен
kmerler	кхмеры
knesset	кнессет
knin	книн
knut	кнуд
kobalt	кобальт
kobe	кобе
koblenz	кобленц
kobra	кобра
kobryn	кобрин
kobuleti	кобулети
kodama	кодама
kodaman	магнат
kodansha	коданся
koguryo	когурё
kohl	коль
kojiki	кодзики
kojuun	кожуун
kokain	кокаин
kokkola	коккола
koku	запах
kokus	кокки
kolej	колледж
kolera	холера
kolesterol	холестерин
kolezyum	колизей
kolhis	колхида
kolhoz	колхоз
kolin	холин
kolit	колит
kollajen	коллаген
kolofon	колофон
kolombiya	колумбия
kolombiyalılar	колумбийцы
kolombo	коломбо
kolomenskoye	коломенское
kolomna	коломна
kolon	колонна
kolye	ожерелье
kolín	колин
koma	кома
komatsu	комацу
kombinasyon	сочетание
kombinatorik	комбинаторика
komedi	комедия
komi	коми
komiser	инспектор
kommersant	коммерсантъ
komorlar	коморы
kompozisyon	композиция
komrat	комрат
komünizm	коммунизм
konak	конак
konakri	конакри
konfederasyon	конфедерация
konfüçyüs	конфуций
konfüçyüsçülük	конфуцианство
koni	конус
konin	конин
konjonktivit	конъюнктивит
konkistador	конкистадор
konotop	конотоп
konsantrasyon	концентрация
konser	концерт
konservatuvar	консерватория
konserve	консервы
konsil	синод
konsolidasyon	консолидация
konsolosluk	консульство
konstans	констант
konstantinopolis	константинополь
konstanz	констанц
konstrüktivizm	конструктивизм
konsül	консул
kontluk	графство
kontralar	контрас
kontralto	контральто
kontrbas	контрабас
kontrplak	фанера
kontrpuan	контрапункт
kontrtenor	контратенор
konveksiyon	конвекция
konvoy	конвой
konyak	коньяк
kopenhag	копенгаген
kopra	копра
koprivnica	копривница
kordon	кордон
kore	корея
korelasyon	корреляция
koreliler	корейцы
koreografi	хореография
korfu	керкира
koridor	коридор
korint	коринф
korku	страх
korniş	карниз
korno	валторна
korosten	коростень
korozyon	коррозия
korsanlık	пиратство
korse	корсет
korsika	корсика
kortrijk	кортрейк
koru	роща
koruma	телохранитель
korvet	корвет
koryaklar	коряки
koryo	корё
korčula	корчула
kostanay	костанай
kostroma	кострома
kostüm	костюм
koszalin	кошалин
kotel	котел
kotelnikovo	котельниково
kotka	котка
kotor	котор
kouvola	коувола
kova	ведро
kovač	ковач
kovboy	ковбой
kovel	ковель
kovrov	ковров
kowalczyk	ковальчик
kowalski	ковальский
koyukuk	коюкук
koza	кокон
kozak	козак
kozalak	шишка
kozana	козани
kozmetik	косметика
kozmoloji	космология
koçana	кочани
koçbaşı	таран
košice	кошице
kraking	крекинг
kraków	краков
kramatorsk	краматорск
krampon	бутсы
kranj	крань
krapina	крапина
krasnodar	краснодар
krasnogorsk	красногорск
krasnoyarsk	красноярск
krater	кратер
kravat	галстук
kredi	кредит
krefeld	крефельд
krema	сливки
kremasyon	кремация
krematoryum	крематорий
kremlin	кремль
kreuzberg	кройцберг
kriegsmarine	кригсмарине
kriket	крикет
krikler	крики
kriminoloji	криминология
kriptanaliz	криптоанализ
kriptografi	криптография
kripton	криптон
krista	кристы
kristal	кристаллы
kristalleştirme	кристаллизация
kristalografi	кристаллография
kristiansand	кристиансанн
kristianstad	кристианстад
kriz	кризис
krizalit	куколка
krişna	кришна
krom	хром
kromatografi	хроматография
kromit	хромит
kromozom	хромосома
kron	крона
kronoloji	хронология
kronometre	секундомер
kronos	кронос
kronstadt	кронштадт
krosno	кросно
krum	крум
krup	круп
krupa	крупа
kruvazör	крейсер
kruşevo	крушево
ksenofon	ксенофонт
ksenon	ксенон
ksilofon	ксилофон
ksilografi	ксилография
kuaför	парикмахер
kuantum	квант
kuasar	квазар
kubbe	купол
kubinka	кубинка
kubrat	кубрат
kuduz	бешенство
kudüs	иерусалим
kuesta	куэста
kufstein	куфштайн
kuji	кудзи
kulaklık	наушники
kule	башня
kulob	куляб
kulübe	хижина
kulüp	клуб
kuma	наложница
kumanlar	половцы
kumano	кумано
kumanova	куманово
kumarhane	казино
kumasi	кумаси
kumaş	ткань
kumtaşı	песчаник
kumuklar	кумыки
kumul	дюна
kunduz	бобры
kunming	куньмин
kunz	кунц
kuomintang	гоминьдан
kuopio	куопио
kupon	купон
kuraklık	засуха
kuray	курай
kuressaare	курессааре
kurgan	курган
kurgulama	редактирование
kurlandiya	курземе
kurt	волк
kurta	курта
kurultay	курултай
kuruluş	организация
kurum	сажа
kurume	куруме
kurye	курьер
kurşun	свинец
kusa	куса
kushiro	кусиро
kutaisi	кутаиси
kutsal	святость
kutu	коробка
kutub	кутб
kuusamo	куусамо
kuvars	кварц
kuveyt	кувейт
kuvvet	сила
kuwana	кувана
kuyruk	хвост
kuzey	север
kuznetsk	кузнецк
kučera	кучера
kuğu	лебеди
kuşatma	осада
kuşkuculuk	скептицизм
kvas	квас
kyme	кима
kyoto	киото
kyūshū	кюсю
kâbil	кабул
kâbus	кошмар
kâfur	камфора
kâhinlik	пророчество
kâzım	казим
kâğıt	бумага
köhler	кёлер
köln	кёльн
könig	кёниг
köpek	собака
köprü	мост
köpük	пена
körling	кёрлинг
körlük	слепота
köstence	констанца
köstendil	кюстендил
kötümserlik	пессимизм
köçekçe	кучек
köşegen	диагональ
köşk	павильон
küba	куба
kübalılar	кубинцы
kübizm	кубизм
kükürt	сера
külhan	топка
külkedisi	золушка
kültür	культура
küme	множество
küpe	серьги
küratör	куратор
küre	сфера
küreselleşme	глобализация
kürk	шерсть
kürtler	курды
kütahya	кютахья
kütle	масса
kütleçekim	гравитация
kütüphane	библиотека
küvet	ванна
kılkış	килкис
kımız	кумыс
kırağı	иней
kırbaç	плеть
kırcaali	кырджали
kırgızistan	киргизия
kırgızlar	киргизы
kırklareli	кыркларели
kırma	помесь
kırmataş	щебень
kırçova	кичево
kırık	кирик
kırım	крым
kırınım	дифракция
kısaltma	аббревиатура
kıskançlık	зависть
kıstak	перешеек
kısırlık	бесплодие
kıta	континент
kıyma	фарш
kıyı	побережье
kızak	сани
kızböcekleri	стрекозы
kızılkanat	краснопёрка
kızılorda	кызылорда
kızılyurt	кизилюрт
kışla	казарма
kışlak	кишлак
kłodzko	клодзко
kōriyama	корияма
lilo	лило
labirent	лабиринт
laboratuvar	лаборатория
labrador	лабрадор
ladakh	ладакх
lagaş	лагаш
lager	лагер
lagos	лагос
lagrange	лагранж
lagün	лагуна
lahey	гаага
lahit	саркофаг
lahor	лахор
lahti	лахти
laird	лэрд
laklar	лакцы
lakonya	лакония
lakota	лакота
lakşmi	лакшми
lale	тюльпан
lama	лама
lamballe	ламбаль
lamda	лямбда
lamego	ламегу
lana	лана
lanark	ланарк
lancashire	ланкашир
lancelot	ланселот
lanciano	ланчано
landshut	ландсхут
landskrona	ландскруна
landtag	ландтаг
landwehr	ландвер
lanet	проклятие
lang	ланг
langres	лангр
languedoc	лангедок
lannion	ланьон
lansing	лансинг
lantan	лантан
lanzhou	ланьчжоу
lanús	ланус
laos	лаос
laponya	лапландия
lappeenranta	лаппеэнранта
laredo	ларедо
lares	лары
larix	лиственница
larnaka	ларнака
larus	чайки
larva	личинка
lateks	латекс
latinus	латин
latte	латте
lauraceae	лавровые
lauro	лауро
laurus	лавр
lausitz	лужица
laval	лаваль
lavandula	лаванда
lavta	лютня
lazarus	лазарус
lazer	лазер
lazio	лацио
lazlar	лазы
lebedev	лебедев
lecce	лечче
lecco	лекко
leda	леда
leeds	лидс
leeuwarden	леуварден
lefkada	лефкас
lefkoşa	никосия
leganés	леганес
legnano	леньяно
legnica	легница
lehi	лехи
lehmann	леманн
leicester	лестер
leiden	лейден
leinster	ленстер
leipzig	лейпциг
leiria	лейрия
leitmotiv	лейтмотив
lemgo	лемго
lemna	ряска
lenfilm	ленфильм
lenfosit	лимфоциты
leninizm	ленинизм
leninogorsk	лениногорск
lenkeran	ленкорань
leoben	леобен
leon	леон
leopold	леопольд
lerma	лерма
leshan	лэшань
leskofça	лесковац
lesotho	лесото
lessing	лессинг
lethbridge	летбридж
lethe	лета
leticia	летисия
letonlar	латыши
letonya	латвия
leuven	лёвен
levant	левант
level	уровень
leverkusen	леверкузен
levi	леви
levin	левин
levine	ливайн
levon	левон
lewandowski	левандовский
leydi	леди
leylak	сирень
lezbiyen	лесбиянка
lezgiler	лезгины
lezginka	лезгинка
leçhumi	лечхуми
lhasa	лхаса
liana	лианы
liaocheng	ляочэн
liaoning	ляонин
liberec	либерец
libertas	либертас
liberya	либерия
libido	либидо
libretto	либретто
libreville	либревиль
libya	ливия
lichtenberg	лихтенберг
licinius	лициний
lida	лида
liderlik	лидерство
lielupe	лиелупе
lienz	лиенц
liepāja	лиепая
ligurya	лигурия
lihtenştayn	лихтенштейн
likenler	лишайники
likud	ликуд
likya	ликия
likör	ликёр
liliaceae	лилейные
lille	лилль
lillehammer	лиллехаммер
lillestrøm	лиллестрём
lilongwe	лилонгве
lima	лима
liman	порт
limana	лимана
limasol	лимасол
limbaži	лимбажи
limburg	лимбург
limerick	лимерик
limni	лемнос
limoges	лимож
limon	лимон
limonata	лимонад
limuzin	лимузин
lincoln	линкольн
lincolnshire	линкольншир
lindau	линдау
lindi	линди
link	линк
linköping	линчёпинг
linyi	линьи
linz	линц
lipetsk	липецк
lipit	липиды
lise	лицей
lisieux	лизьё
lisp	лисп
litvanlar	литовцы
lityum	литий
litürji	литургия
livadya	левадия
livno	ливно
livonya	ливония
livorno	ливорно
lizbon	лиссабон
lizin	лизин
liçi	личи
liège	льеж
ljubljana	любляна
lleida	льейда
lobnya	лобня
locarno	локарно
lodi	лоди
logan	логан
logaritma	логарифм
logos	логос
logroño	логроньо
lohja	лохья
loiret	луаре
lojistik	логистика
loko	локо
lokomotif	локомотив
lokus	локус
lola	лола
lombardiya	ломбардия
lombok	ломбок
lomlar	боша
lomé	ломе
londrina	лондрина
longjumeau	лонжюмо
lonicera	жимолость
lord	лорд
loreen	лорин
loren	лотарингия
lorenz	лоренц
lori	лори
lorient	лорьян
louisiana	луизиана
loulé	лоле
lozan	лозанна
lozère	лозер
luanda	луанда
lubin	любин
lublin	люблин
lubumbashi	лубумбаши
lucania	лукания
lucas	люка
lucca	лукка
lucifer	люцифер
lucknow	лакхнау
lucretia	лукреция
ludwigsburg	людвигсбург
luga	луга
lugano	лугано
lugo	луго
luhansk	луганск
luis	луиш
lukoil	лукойл
luleå	лулео
lumbini	лумбини
lund	лунд
lundy	ланди
lurlar	луры
lusaka	лусака
luscinia	соловьи
lusitania	лузитания
lustenau	лустенау
luton	лутон
lutsk	луцк
luzern	люцерн
luzhou	лучжоу
luzon	лусон
lviv	львов
lycaenidae	голубянки
lyon	лион
lääne	ляэнемаа
lökopeni	лейкопения
lörrach	лёррах
lösemi	лейкоз
lösin	лейцин
lúcio	лусио
lübnan	ливан
lügatçe	лексика
lüksemburg	люксембург
lüneburg	люнебург
lütercilik	лютеранство
maar	маар
maardu	маарду
maastricht	маастрихт
mabel	мейбл
macapá	макапа
macaristan	венгрия
macarlar	венгры
macbeth	макбет
maceió	масейо
macerata	мачерата
machida	матида
macrinus	макрин
madagaskar	мадагаскар
madalena	мадалена
madalya	медаль
madalyon	медальон
madenci	шахтёр
madrid	мадрид
madrigal	мадригал
maebashi	маэбаси
mafra	мафра
mafya	мафия
magadan	магадан
magas	магас
magdeburg	магдебург
magma	магма
magnezyum	магний
magnifikasyon	увеличение
magnitogorsk	магнитогорск
magnum	магнум
mahabharata	махабхарата
mahatma	махатма
mahaçkale	махачкала
mahmuz	отрог
maidenhead	мейденхед
maidstone	мейдстон
mainz	майнц
maisur	майсур
majapahit	маджапахит
majisyen	колдун
maksim	макsим
makao	макао
makaron	макарон
makas	ножницы
makedonlar	македонцы
makine	машина
makinist	токарь
makrofaj	макрофаги
makyöz	визажист
malahit	малахит
malatya	малатья
malavi	малави
malaylar	малайцы
malbork	мальборк
maldivler	мальдивы
malezya	малайзия
mali	мали
malinowski	малиновский
maliye	налоги
maliyet	затраты
malmö	мальмё
maloyaroslavets	малоярославец
malpighiales	мальпигиецветные
malt	солод
malta	мальта
malvaceae	мальвовые
mama	мама
mamadış	мамадыш
mamo	мамо
mamut	мамонты
manado	манадо
managua	манагуа
manastır	монастырь
manaus	манаус
manche	манш
manchester	манчестер
mancınık	катапульта
manda	манда
mandala	мандала
mandalina	мандарин
mandolin	мандолина
mangaka	мангака
manganez	марганец
mangrov	мангры
manhattan	манхэттен
mani	мани
manifesto	манифест
manila	манила
manipur	манипур
manipülasyon	манипуляция
manisaspor	манисаспор
manitoba	манитоба
manitu	маниту
mann	манн
manna	манна
mannheim	мангейм
mano	мано
manolo	махо
manolya	магнолия
manometre	манометр
manresa	манреса
manto	манто
mantova	мантуя
mantra	мантра
mantık	логика
manu	ману
manus	манус
manyetit	магнетит
manyetizma	магнетизм
manyeto	магнето
manzanillo	мансанильо
manzini	манзини
mançular	маньчжуры
mançurya	маньчжурия
maputo	мапуту
marakeş	марракеш
maranhão	мараньян
maraton	марафон
marbella	марбелья
marburg	марбург
marcelo	марсело
marcianus	маркиан
mardan	мардан
marduk	мардук
marengo	маренго
mareşal	маршал
margareten	маргаретен
mari	мари
maribor	марибор
mariehamn	мариехамн
marietta	мариетта
marijampolė	мариямполе
marimba	маримба
mariner	маринер
maringá	маринга
mario	марио
mariupol	мариуполь
marka	бренд
marki	маркиз
marksizm	марксизм
marlborough	марлборо
marn	мергель
marne	марна
marneuli	марнеули
maroua	маруа
mars	марс
marsilya	марсель
marslı	марсиане
mart	март
marta	марта
martens	мартенс
martigues	мартиг
martin	мартин
martinik	мартиника
maryland	мэриленд
marília	марилия
masal	сказка
masallı	масаллы
maseru	масеру
maskat	маскат
maske	маска
masonluk	масонство
massachusetts	массачусетс
master	мастер
mastering	мастеринг
matabeleland	матабелеленд
matanzas	матансас
matbaacılık	печатание
matematik	математика
matematikçi	математик
matenadaran	матенадаран
matera	матера
materyalizm	материализм
mathura	матхура
matosinhos	матозиньюш
matrix	матрикс
matsue	мацуэ
matsuyama	мацуяма
matta	матта
matterhorn	маттерхорн
maui	мауи
maun	махагони
maurer	маурер
mauritius	маврикий
maxentius	максенций
maximianus	максимиан
maximum	максимум
mayer	майер
maykop	майкоп
maymun	обезьяны
mayonez	майонез
mayotte	майотта
mağara	пещера
mağrip	магриб
mažeikiai	мажейкяй
mccarthy	маккарти
mecaz	метафора
mechelen	мехелен
mecklenburg	мекленбург
mecoptera	скорпионницы
medan	медан
medea	медея
medine	медина
meditasyon	медитация
medrese	медресе
medyum	медиум
megabayt	мегабайт
megafon	мегафон
megalit	мегалит
megan	меган
megara	мегара
meghalaya	мегхалая
megreller	мегрелы
mehdi	махди
meiningen	майнинген
mejdureçensk	междуреченск
mekanik	механика
mekanizma	механизм
mekke	мекка
meknes	мекнес
mekong	меконг
meksika	мексика
meksikalılar	мексиканцы
meksiko	мехико
mektep	мектеб
mektup	письмо
melankoli	меланхолия
melbourne	мельбурн
mele	меле
melek	ангел
melik	малик
melilla	мелилья
melitopol	мелитополь
melk	мельк
melodika	мелодика
melodram	мелодрама
melpomene	мельпомена
meltem	бриз
melun	мелён
memeliler	млекопитающие
memlûk	мамлюки
menajer	менеджер
menajeri	зверинец
menderes	меандр
menelaos	менелай
menenjit	менингит
menhir	менгир
meni	сперма
menton	ментона
menua	менуа
menşevik	меньшевики
mephistopheles	мефистофель
mera	пастбище
merak	любопытство
merano	мерано
mercek	линза
mercer	мерсер
merdiven	лестница
merhaba	салам
merhem	мазь
meriç	марица
merkezileşme	централизация
merkür	меркурий
merlin	мерлин
merlot	мерло
mermer	мрамор
mermi	пуля
meroe	мероэ
merseburg	мерзебург
merseyside	мерсисайд
mersin	мерсин
merv	мерв
mervan	марван
meryem	богородица
mesafe	расстояние
mesaj	сообщение
mesih	мессия
meslek	профессия
mesrob	месроп
messier	мессье
messina	мессина
messing	мессинг
mestizo	метисы
metabolit	метаболиты
metadata	метаданные
metafizik	метафизика
metal	металлы
metalcore	металкор
metallik	металличность
metalurji	металлургия
metan	метан
metanol	метанол
meteor	метеорит
meteora	метеора
meteorolog	метеоролог
meteoroloji	метеорология
metilasyon	метилирование
metin	текст
metković	меткович
metre	метр
metro	метрополитен
metroloji	метрология
metronom	метроном
metropol	мегаполис
metropolit	митрополит
mettmann	меттман
mevzuat	законодательство
mexicali	мехикали
meyer	мейер
meyil	тенденция
meyve	плод
mezar	могила
mezarlık	кладбище
mezhep	секта
mezoamerika	мезоамерика
mezon	мезон
mezopotamya	месопотамия
mezra	деревня
meşale	факел
meşhed	мешхед
miami	майами
mianyang	мяньян
miass	миасс
michelangelo	микеланджело
michigan	мичиган
michoacán	мичоакан
mickey	микки
middlesex	мидлсекс
midlothian	мидлотиан
midraş	мидраш
mielec	мелец
mihrace	махараджа
mihrap	михраб
mika	слюды
mikeladze	микеладзе
miken	микены
mikkeli	миккели
miko	мико
mikonos	миконос
mikoyan	микоян
mikrorna	микрорнк
mikrobilgisayar	микрокомпьютер
mikrobiyoloji	микробиология
mikrocerrahi	микрохирургия
mikrodenetleyici	микроконтроллер
mikrofon	микрофон
mikroiklim	микроклимат
mikroişlemci	микропроцессор
mikronezya	микронезия
mikroorganizma	микроорганизмы
mikroskobi	микроскопия
mikroskop	микроскоп
mikrotübül	микротрубочки
milano	милан
milet	милет
milimetre	миллиметр
militarizm	милитаризм
millerovo	миллерово
millet	нация
milliyet	национальность
milliyetçilik	национализм
milošević	милошевич
milwaukee	милуоки
milyarder	миллиардер
milyon	миллион
milyoner	миллионер
mimar	архитектор
mimarlık	архитектура
mimik	мимика
mina	мина
minato	минато
mindaugas	миндовг
minden	минден
mineiro	минейро
mineral	минерал
mineroloji	минералогия
minerva	минерва
minibüs	микроавтобус
minimalizm	минимализм
minivan	минивэн
minkowski	минковский
minneapolis	миннеаполис
minnesota	миннесота
minnet	благодарность
minogue	миноуг
minorka	менорка
minos	минос
minotor	минотавр
minsk	минск
mintaka	минтака
minusinsk	минусинск
minyatür	миниатюра
mira	мира
miri	мири
mirin	мирин
miryam	мириам
miryang	мирян
misafirperverlik	гостеприимство
miselyum	мицелий
misina	леска
miskitolar	мискито
mississauga	миссиссога
mistisizm	мистицизм
mistral	мистраль
mitanni	митанни
mithat	митхат
mitoloji	мифология
mitoz	митоз
mius	миус
mixtape	микстейп
miyosen	миоцен
mizah	юмор
mizoram	мизорам
moana	моана
mobilya	мебель
moby	моби
moda	мода
modem	модем
modena	модена
modernizm	модернизм
modül	модуль
modülasyon	модуляция
mogadişu	могадишо
mogilyov	могилёв
moho	мохо
mojaysk	можайск
molde	молде
moldova	молдавия
molekül	молекула
molibden	молибден
molise	молизе
molière	мольер
molla	мулла
molsheim	мольсем
moltke	мольтке
moment	момент
momentum	импульс
momo	момо
monako	монако
monarşi	монархия
moncton	монктон
monfalcone	монфальконе
monferrato	монферрат
mongu	монгу
monmouthshire	монмутшир
monogatari	моногатари
monografi	монография
monogram	монограмма
monokok	монокок
monolit	монолит
monolog	монолог
monomer	мономер
monoray	монорельс
monreale	монреале
monrovia	монровия
montana	монтана
montauban	монтобан
montbéliard	монбельяр
montevideo	монтевидео
montgomery	монтгомери
monticello	монтичелло
montluçon	монлюсон
montmartre	монмартр
montparnasse	монпарнас
montpellier	монпелье
montreal	монреаль
montrouge	монруж
montrö	монтрё
montserrat	монтсеррат
monza	монца
monzón	монсон
mopti	мопти
mora	мора
moraceae	тутовые
moravya	моравия
morbihan	морбиан
mordovya	мордовия
morelia	морелия
morelos	морелос
moren	морена
morfin	морфин
morfoloji	морфология
morg	морг
moria	мория
morioka	мориока
moritanya	мавритания
morlaix	морле
morolar	мавры
moroni	морони
morozovsk	морозовск
morris	моррис
morrissey	моррисси
morse	морзе
mosfilm	мосфильм
moshi	моши
moskova	москва
mossad	моссад
mostar	мостар
motacilla	трясогузки
motel	мотель
motor	двигатель
motosiklet	мотоцикл
mouscron	мускрон
mozambik	мозамбик
mozdok	моздок
moğolistan	монголия
moğollar	монголы
moşav	мошав
mpumalanga	мпумаланга
mtsensk	мценск
mtsheta	мцхета
muaskar	маскара
mubarek	мубарек
mucur	гравий
mudanjiang	муданьцзян
muhaddis	мухаддис
muhafaza	мухафаза
muhafazakârlık	консерватизм
muhalefet	оппозиция
muhalif	диссидент
muhammed	мухаммед
muharrem	мухаррам
muhasebeci	бухгалтер
mujik	мужик
mukavva	картон
mula	мула
mulatto	мулаты
multan	мултан
mumbai	мумбаи
mumya	мумия
muraena	мурены
murakami	мураками
murano	мурано
murat	мюра
murcia	мурсия
mureș	муреш
murmansk	мурманск
muro	муро
murom	муром
musa	моисей
musashino	мусасино
muska	амулет
muson	муссон
musul	мосул
mutasyon	мутация
mutluluk	счастье
muzgiller	банановые
muğam	мугам
mwanza	мванза
myrtaceae	миртовые
mysterio	мистерио
málaga	малага
mâcon	макон
mérida	мерида
mödling	мёдлинг
mönchengladbach	мёнхенгладбах
möngke	мункэ
mörön	мурэн
müftü	муфтий
mükemmellik	совершенство
mülakat	интервью
mülheim	мюльхайм
müller	мюллер
mülteci	беженцы
münazara	дебаты
münih	мюнхен
münster	мюнстер
mürekkep	чернила
müsavat	мусават
müslüman	мусульманин
mütareke	перемирие
müzakere	переговоры
müzayede	аукцион
müze	музей
müzik	музыка
müzikoloji	музыковедение
müzisyen	музыкант
müzler	музы
müşteri	заказчик
mıknatıs	магнит
mısır	египет
mısırlılar	египтяне
mıtişçi	мытищи
mızrak	копьё
nablus	наблус
nabu	набу
nabız	пульс
nadas	залежь
nadire	надира
nagaland	нагаленд
nagano	нагано
nagasaki	нагасаки
nagoya	нагоя
nagpur	нагпур
nahodka	находка
naim	наим
nain	наин
naip	регент
nairobi	найроби
nakarat	рефрен
nakatsu	накацу
nakuru	накуру
nakşa	наксос
nalçik	нальчик
namaz	намаз
namibya	намибия
nampho	нампхо
namur	намюр
nanchang	наньчан
nancy	нанси
nane	мята
nani	нани
nankin	нанкин
nanterre	нантер
nantes	нант
nanyang	наньян
napier	нейпир
narayana	нараяна
nargile	кальян
narita	нарита
nariño	нариньо
narkoz	наркоз
naro	наро
narteks	притвор
narvik	нарвик
nashville	нашвилл
nasıra	назарет
natüralizm	натурализм
natürmort	натюрморт
nauru	науру
navarin	пилос
navarro	наварро
nayarit	наярит
naylon	нейлон
nazaré	назаре
nazran	назрань
nağara	нагара
naşim	нашим
našice	нашице
nebraska	небраска
nebula	туманность
necaxa	некакса
necaşi	негус
necid	неджд
neckar	неккар
necran	наджран
nedime	фрейлина
neftekamsk	нефтекамск
nefteyugansk	нефтеюганск
nehir	река
neka	нека
nekropol	некрополь
nekroz	некроз
nema	нема
nemengan	наманган
nemf	нимфы
nemrud	нимрод
nene	нене
neon	неон
neoptolemos	неоптолем
nepal	непал
nepomuk	непомук
neptün	нептун
neretva	неретва
neron	нерон
neruda	неруда
nerva	нерва
neryungri	нерюнгри
nerçinsk	нерчинск
nesebar	несебыр
nesil	поколение
nesir	проза
nesnellik	объективность
nesîmî	насими
netanya	нетания
neubrandenburg	нойбранденбург
neuchâtel	невшатель
neuquén	неукен
neuss	нойс
neustrelitz	нойштрелиц
neuwied	нойвид
nevada	невада
nevel	невель
nevinnomıssk	невинномысск
nevis	невис
nevroz	невроз
nevruz	навруз
nevşehir	невшехир
newark	ньюарк
newry	ньюри
newton	ньютон
neşter	скальпель
niamey	ниамей
nice	ницца
nicelik	количество
nicole	николь
nida	нида
nijer	нигер
nijerya	нигерия
nijnevartovsk	нижневартовск
nikaragua	никарагуа
nikel	никель
nikkō	никко
nikolov	николов
nikomedia	никомедия
nikotin	никотин
ningbo	нинбо
ninja	ниндзя
ninjutsu	ниндзюцу
ninurta	нинурта
niort	ньор
nippur	ниппур
nirvana	нирвана
nisan	апрель
nishio	нисио
niterói	нитерой
nitra	нитра
nitrat	нитраты
niue	ниуэ
nivelles	нивель
niçiren	нитирэн
nièvre	ньевр
niğbolu	никопол
nişabur	нишапур
nişan	обручение
nişangâh	прицел
nişasta	крахмал
nobel	нобель
nogaylar	ногайцы
noginsk	ногинск
nogueira	ногейра
noktalama	пунктуация
nola	нола
nolan	нолан
noldor	нолдор
noli	ноли
noodle	лапша
nord	норд
nordhausen	нордхаузен
nordland	нурланн
norfolk	норфолк
noricum	норик
norilsk	норильск
normanlar	норманны
norrköping	норрчёпинг
northampton	нортгемптон
northamptonshire	нортгемптоншир
northumberland	нортамберленд
northumbria	нортумбрия
norveç	норвегия
norveçliler	норвежцы
norwich	норидж
nosferatu	носферату
nostalji	ностальгия
nota	нота
noter	нотариус
nottingham	ноттингем
nottinghamshire	ноттингемшир
nouméa	нумеа
novara	новара
novokuznetsk	новокузнецк
novorossiysk	новороссийск
novosibirsk	новосибирск
novoçerkassk	новочеркасск
novoşahtinsk	новошахтинск
noyabrsk	ноябрьск
nuakşot	нуакшот
nukus	нукус
numazu	нумадзу
numidya	нумидия
nunavut	нунавут
nurhaci	нурхаци
nyagan	нягань
nymburk	нимбурк
nymphaea	кувшинка
nymphalidae	нимфалиды
nyíregyháza	ньиредьхаза
náchod	наход
náutico	наутико
nöroloji	неврология
nörotoksin	нейротоксин
nötrino	нейтрино
nötron	нейтрон
nübye	нубия
nükleotit	нуклеотиды
nüklit	нуклид
nükte	эпиграмма
nümismatik	нумизматика
nürburgring	нюрбургринг
nürnberg	нюрнберг
nāga	наги
oahu	оаху
oberhausen	оберхаузен
obernai	оберне
obezite	ожирение
obihiro	обихиро
oblomov	обломов
obninsk	обнинск
obua	гобой
obüs	гаубица
ocak	январь
odawara	одавара
odeion	одеон
odense	оденсе
odessa	одесса
odin	один
odintsovo	одинцово
odisseus	одиссей
odivelas	одивелаш
odoacer	одоакр
odun	дрова
odysseia	одиссея
offenbach	оффенбах
ofis	офис
ogaden	огаден
ogasawara	огасавара
ohotsk	охотск
ohri	охрид
okaliptüs	эвкалипт
okazaki	окадзаки
oklahoma	оклахома
okrug	округ
oksijen	кислород
oksit	оксиды
oktan	октан
oktav	октава
oktay	октай
okul	школа
okuryazarlık	грамотность
okyanus	океан
olasılık	вероятность
oldenburg	ольденбург
oldham	олдем
olea	маслина
olgu	факт
oligosen	олигоцен
olinda	олинда
olivin	оливин
ollie	олли
olomouc	оломоуц
olonets	олонец
olsztyn	ольштын
ombudsman	омбудсмен
omega	омега
omen	омен
omsk	омск
omurga	позвоночник
omurgalılar	позвоночные
omurgasızlar	беспозвоночные
omurtag	омуртаг
onaylama	ратификация
onbaşı	капрал
onega	онега
oniks	оникс
onkoloji	онкология
onomastik	ономастика
ontario	онтарио
ontoloji	онтология
onyıl	десятилетие
oolong	улун
oostende	остенде
opal	опал
opatija	опатия
opava	опава
opera	опера
operatör	оператор
operet	оперетта
opole	ополе
oppland	оппланн
optik	оптика
oraj	гроза
orak	серп
orakl	оракул
oramiral	адмирал
oratoryo	оратория
orchidaceae	орхидные
oregon	орегон
orenburg	оренбург
orestes	орест
orfeus	орфей
organel	органеллы
organik	органика
orgy	оргия
origami	оригами
origenes	ориген
oristano	ористано
orkestra	оркестр
orléans	орлеан
ormancılık	лесоводство
ormangülü	рододендрон
orsk	орск
orta	орта
ortografi	орфография
ortona	ортона
ortopedi	ортопедия
orvieto	орвието
orşa	орша
osaka	осака
osetler	осетины
osetya	осетия
oshawa	ошава
osijek	осиек
osimo	озимо
osiris	осирис
oslo	осло
osnabrück	оснабрюк
ossi	осси
ostaşkov	осташков
ostrava	острава
ostrovski	островский
osuna	осуна
otaku	отаку
otaru	отару
otel	гостиница
othello	отелло
otho	отон
otis	отис
otizm	аутизм
otobiyografi	автобиография
otobüs	автобус
otogar	автостанция
otomasyon	автоматизация
otopsi	вскрытие
otorite	авторитет
otoyol	автомагистраль
otranto	отранто
ottawa	оттава
oudenaarde	ауденарде
oulu	оулу
overijssel	оверэйссел
overton	овертон
ovidius	овидий
oviedo	овьедо
oxford	оксфорд
oxfordshire	оксфордшир
oydaşma	консенсус
oylama	голосование
oyrat	ойраты
oyun	игра
oyuncak	игрушка
oyuncu	актёр
ozan	озан
ozon	озон
ozurgeti	озургети
oğlan	мальчик
padang	паданг
paddington	паддингтон
paderborn	падерборн
padişah	падишах
padmasambhava	падмасамбхава
padova	падуя
paganizm	язычество
pagoda	пагода
pahang	паханг
paide	пайде
pakistan	пакистан
paladyum	палладий
palau	палау
paldiski	палдиски
palencia	паленсия
palenque	паленке
paleontoloji	палеонтология
palermo	палермо
palestrina	палестрина
pali	пали
pallas	паллас
palmer	палмер
palmira	пальмира
palmiye	пальмовые
palto	пальто
palyaço	клоун
pamela	памела
pamfilya	памфилия
pampa	пампа
pamplona	памплона
pamuk	хлопок
panagürişte	панагюриште
panama	панама
pancar	свёкла
pandava	пандавы
pandora	пандора
panevėžys	паневежис
panicum	просо
panik	паника
panini	панини
pankreatit	панкреатит
pannonia	паннония
pansiyon	пансионат
pansuman	повязка
pantanal	пантанал
panteon	пантеон
panthera	пантеры
panzehir	противоядие
pançova	панчево
papa	папство
papadopulos	пападопулос
paparazi	папарацци
papaya	папайя
papaz	священник
papirüs	папирус
para	деньги
parabol	парабола
paradoks	парадокс
paraguay	парагвай
paramaribo	парамарибо
parametre	параметр
paranoya	паранойя
parantez	скобки
parasetamol	парацетамол
parazitlik	паразитизм
parazitoloji	паразитология
paraíba	параиба
pardubice	пардубице
pardösü	шинель
pareto	парето
parfüm	духи
paris	париж
parish	приход
park	парк
parke	паркет
parkur	тропа
parlamento	парламент
parma	парма
parmak	палец
parodi	пародия
parola	пароль
pars	леопард
parsek	парсек
parti	парти
partisyon	партитура
parton	партон
parvati	парвати
parçacık	частица
parşömen	пергамент
pasaport	паспорт
pasarofça	пожаревац
pascual	паскуаль
passau	пассау
pasta	торт
patagonya	патагония
patara	патара
patates	картофель
patent	патент
pathos	пафос
pati	лапа
patiska	батист
patlama	взрыв
patna	патна
patogenez	патогенез
patojen	патоген
patti	патти
pavlodar	павлодар
pavlovo	павлово
payanda	опора
paytakaran	пайтакаран
pazarlama	маркетинг
pazartesi	понедельник
pedagog	педагог
pedagoji	педагогика
pediatri	педиатрия
pegasus	пегас
pekin	пекин
pelagius	пелагий
pelikan	пеликаны
pelotas	пелотас
pelé	пеле
pemba	пемба
penafiel	пенафиел
penang	пинанг
pencap	пенджаб
pencapça	панджаби
penelope	пенелопа
penglai	пэнлай
peni	пенни
penia	пения
pense	щипцы
pensilvanya	пенсильвания
pentagon	пентагон
penza	пенза
pençe	коготь
pepsi	пепси
peptit	пептиды
perak	перак
percy	перси
perde	шторы
perdix	куропатки
perfore	перфорация
pergamon	пергам
pergel	циркуль
perikles	перикл
periskop	перископ
periyot	период
perm	пермь
permütasyon	перестановка
pernik	перник
perpignan	перпиньян
perseus	персей
perspektif	перспектива
perth	перт
pertinax	пертинакс
perugia	перуджа
peruk	парик
perşembe	четверг
pesaro	пезаро
peso	песо
pestisit	пестициды
petre	петре
petroglif	петроглифы
petrol	нефть
petroloji	петрология
petropolis	петрополис
petrozavodsk	петрозаводск
peya	пейя
peygamber	пророк
peyzaj	ландшафт
peçenekler	печенеги
peşaver	пешавар
peşte	пешт
peştuca	пушту
peştunlar	пуштуны
phaethon	фаэтон
phalaenopsis	фаленопсис
phaseolus	фасоль
phasianus	фазаны
phelps	фелпс
philadelphia	филадельфия
philia	филия
phoebe	феба
phoenix	финикс
piacenza	пьяченца
piauí	пиауи
picardie	пикардия
pick	пикк
pietà	пьета
piešťany	пьештяни
pigment	пигмент
piknik	пикник
piksel	пиксель
piktler	пикты
pilas	пилас
pilav	плов
pilot	лётчик
pilsen	пльзень
pilus	пили
pindaros	пиндар
pinerolo	пинероло
pingdingshan	пиндиншань
pingliang	пинлян
pinokyo	пиноккио
pinyin	пиньинь
piombino	пьомбино
piracicaba	пирасикаба
piran	пиран
pire	блохи
pireneler	пиренеи
piri	пири
pirit	пирит
pirlepe	прилеп
piroliz	пиролиз
pirsing	пирсинг
pisa	пиза
pisagor	пифагор
pisco	писко
piskopos	епископ
pistacia	фисташка
pistoia	пистоя
piston	поршень
pisum	горох
pita	пита
piteşti	питешти
piti	пити
pitsunda	пицунда
pitt	питт
pittsburgh	питтсбург
pivot	центровой
piyade	пехота
piyango	лотерея
piyanist	пианист
piyano	фортепиано
piyemonte	пьемонт
piyes	пьеса
piyon	пешка
pizza	пицца
placozoa	пластинчатые
plaj	пляж
plak	грампластинка
plaka	плака
planetaryum	планетарий
planlama	планирование
plantaginaceae	подорожниковые
plantago	подорожник
plantasyon	плантация
plasenta	плацента
plastik	пластмассы
platin	платина
platon	платон
plauen	плауэн
plazma	плазма
plazmid	плазмиды
pleb	плебеи
pleiade	плеяда
pleiades	плеяды
pleistosen	плейстоцен
plevne	плевен
pliyosen	плиоцен
ploiești	плоешти
plotinos	плотин
ploče	плоче
plutarhos	плутарх
plön	плён
plüton	плутон
plütonyum	плутоний
pocahontas	покахонтас
podestà	подеста
podgorica	подгорица
podolsk	подольск
podolski	подольский
podolya	подолье
poena	пэна
pogrom	погром
pohang	пхохан
poincaré	пуанкаре
poitiers	пуатье
poitou	пуату
poker	покер
pokémon	покемон
polemik	полемика
polen	пыльца
polesiye	полесье
polietilen	полиэтилен
polifonik	полифония
poliklinik	поликлиника
polimer	полимеры
polimeraz	полимераза
polimerizasyon	полимеризация
polinezya	полинезия
polinezyalılar	полинезийцы
polinom	многочлен
polis	полиция
polisakkarit	полисахариды
polisario	полисарио
politbüro	политбюро
polka	полька
polkowice	польковице
polo	поло
polonez	полонез
polonya	польша
polotsk	полоцк
poltava	полтава
polye	полье
polygonaceae	гречишные
pomona	помона
pomorie	поморие
pompa	насос
pondiçeri	пондичерри
pontecorvo	понтекорво
pontevedra	понтеведра
ponti	понти
pontoise	понтуаз
pontus	понт
popescu	попеску
poprad	попрад
pordenone	порденоне
porfiria	порфирия
porfirogennetos	багрянородный
pori	пори
pornografi	порнография
porozite	пористость
porselen	фарфор
portakal	апельсин
portalegre	порталегри
portekiz	португалия
portekizliler	португальцы
portici	портичи
portland	портленд
porto	порту
portre	портрет
portsmouth	портсмут
portugalete	португалете
poseidon	посейдон
posesyon	одержимость
post	овчина
posta	почта
postacı	почтальон
postmodernizm	постмодернизм
potentilla	лапчатка
potenza	потенца
poti	поти
potosí	потоси
potpuri	попурри
potsdam	потсдам
pound	паунд
pozitivizm	позитивизм
poznań	познань
praetor	претор
prag	прага
praia	прая
prato	прато
pravadı	провадия
pravets	правец
prefektörlük	префектура
prens	принц
prenslik	княжество
press	пресс
pretoria	претория
prešov	прешов
prijedor	приедор
primat	приматы
primorsko	приморско
princeps	принцепс
principes	принципы
prisma	призма
prizren	призрен
priştine	приштина
probus	проб
proculus	прокул
profesyonel	профессионал
profesör	профессор
prognoz	прогноз
program	программа
programlama	программирование
projektör	прожектор
prokaryot	прокариоты
prokonsül	проконсул
prokopia	прокопия
prokopyevsk	прокопьевск
proletarya	пролетариат
prolin	пролин
prometheus	прометей
promosyon	продвижение
propaganda	пропаганда
propan	пропан
propylon	пропилеи
prospekt	проспект
protagonist	протагонист
protein	белки
protestanlık	протестантизм
protesto	протест
protez	протезирование
prothonotary	протонотарий
protistler	протисты
proton	протон
prototype	прототип
protozoa	простейшие
provence	прованс
prunus	слива
prusya	пруссия
przemyśl	пшемысль
prüm	прюм
psikanaliz	психоанализ
psikiyatr	психиатр
psikiyatri	психиатрия
psikoloji	психология
psikoterapi	психотерапия
psikoz	психоз
psişe	психика
psişik	экстрасенс
pskov	псков
psyche	психея
psyol	псёл
ptah	птах
ptuj	птуй
pudra	порошок
puebla	пуэбла
puglia	апулия
puhu	филин
pula	пула
puli	пули
pullular	чешуйчатые
pulsar	пульсар
punch	панч
pune	пуна
puntland	пунтленд
pupa	корма
puranalar	пураны
putumayo	путумайо
puławy	пулавы
puşi	куфия
puşkino	пушкино
pyatigorsk	пятигорск
pyongyang	пхеньян
pyrrha	пирра
pyrrhula	снегири
pärnu	пярну
périgueux	перигё
péruwelz	перювельз
płock	плоцк
příbram	пршибрам
qamdo	чамдо
qinhuangdao	циньхуандао
qiqihar	цицикар
quadriga	квадрига
quaestor	квестор
quasimodo	квазимодо
quattrocento	кватроченто
quedlinburg	кведлинбург
queens	куинс
queensland	квинсленд
quena	кена
querétaro	керетаро
quetzaltenango	кесальтенанго
quietus	квиет
quimper	кемпер
quirinus	квирин
quito	кито
québec	квебек
raab	рааб
rabat	рабат
rabaul	рабаул
racastan	раджастхан
radcliffe	рэдклифф
radikal	радикал
radikalizm	радикализм
radom	радом
radomir	радомир
radomsko	радомско
radon	радон
radyatör	радиатор
radyo	радио
radyografi	рентгенография
radyometre	радиометр
radyum	радий
rafting	рафтинг
ragusa	рагуза
rahatsızlık	раздражение
rahel	рахиль
rahman	рахман
rahula	рахула
raja	раджа
rajshahi	раджшахи
rakam	цифры
raket	ракетка
rakovník	раковник
rakun	еноты
rakvere	раквере
ralli	ралли
rallus	пастушки
rama	рама
ramayana	рамаяна
ramazan	рамадан
rambler	рамблер
ramenskoye	раменское
rancagua	ранкагуа
ranchi	ранчи
rand	ранд
randers	раннерс
ranunculaceae	лютиковые
rapallo	рапалло
rapcore	рэпкор
rapor	доклад
rashi	раши
rast	раст
rasyonalizm	рационализм
rasyonellik	рациональность
rauch	раух
ravalpindi	равалпинди
rave	рейв
ravenna	равенна
razgrad	разград
raça	рача
reading	рединг
reaktör	реактор
realizm	реализм
rebeka	ревекка
recep	раджаб
recife	ресифи
reconquista	реконкиста
reds	красные
redwood	редвуд
reenkarnasyon	реинкарнация
referandum	референдум
reform	реформа
regatta	регата
regensburg	регенсбург
regresyon	регрессия
rehabilitasyon	реабилитация
rehber	экскурсовод
rehinci	ломбард
rehine	заложник
rehovot	реховот
reich	рейх
reichskommissariat	рейхскомиссариат
reichsmarine	рейхсмарине
reichswehr	рейхсвер
reims	реймс
rejisör	режиссёр
rekabet	соперничество
reklam	реклама
rektör	ректор
rembrandt	рембрандт
remiks	ремикс
remscheid	ремшайд
rendsburg	рендсбург
renfrew	ренфру
renk	цвет
renyum	рений
requiem	реквием
resepsiyon	рецепция
resim	живопись
restoran	ресторан
rethel	ретель
retorik	риторика
retrospektif	ретроспектива
reus	реус
reuters	рейтер
reutlingen	ройтлинген
reutov	реутов
revak	портик
revü	ревю
reykjavík	рейкьявик
reyting	рейтинг
rezerv	резерв
rezin	резина
reçel	джем
reçine	смола
reşt	решт
riau	риау
ribeira	рибейра
ricardo	рикарду
richard	ричард
richelieu	ришельё
richmond	ричмонд
riesling	рислинг
rieti	риети
rift	рифт
riga	рига
rigel	ригель
rigoletto	риголетто
rigveda	ригведа
rijeka	риека
rijitlik	жёсткость
rimini	римини
rinzai	риндзай
rionegro	рионегро
risk	риск
ritim	ритм
riva	рива
riverside	риверсайд
rivoli	риволи
riyazet	воздержание
rjev	ржев
roadster	родстер
roanne	роан
robot	робот
robotik	робототехника
rochdale	рочдейл
rochester	рочестер
rockabilly	рокабилли
rockefeller	рокфеллер
rocky	рокки
rocroi	рокруа
rodeo	родео
rodez	родез
rodos	родос
rodyum	родий
roerich	рерих
roeselare	руселаре
rogaland	ругаланн
rohan	рохан
roket	ракета
rokfor	рокфор
rokoko	рококо
roksana	роксана
roll	ролл
romagna	романья
roman	роман
romanizasyon	романизация
romantizm	романтизм
romanya	румыния
romatizma	ревматизм
romário	ромарио
ronaldinho	роналдиньо
ronaldo	роналдо
ronda	ронда
rondo	рондо
rondônia	рондония
ronin	ронин
rooney	руни
roosevelt	рузвельт
roraima	рорайма
rosaceae	розовые
rosario	росарио
rosatom	росатом
roseau	розо
rosenberg	розенберг
rosenheim	розенхайм
rosenthal	розенталь
rosette	розетка
roskilde	роскилле
roslavl	рославль
rosmarinus	розмарин
rosneft	роснефть
ross	росс
rossano	россано
rosso	росо
rostelecom	ростелеком
rostock	росток
rostov	ростов
rotherham	ротерем
rotterdam	роттердам
rouen	руан
rovaniemi	рованиеми
rovereto	роверето
rovigo	ровиго
ruanda	руанда
ruano	руано
rubai	рубаи
rubiaceae	мареновые
rubicon	рубикон
rubinstein	рубинштейн
ruble	рубль
rubtsovsk	рубцовск
rudolstadt	рудольштадт
rufina	руфина
rulet	рулетка
rumba	румба
rumenler	румыны
rumex	щавель
rupi	рупия
rurik	рюрик
rusalka	русалка
rusinler	русины
ruslar	русские
russi	русси
russulaceae	сыроежковые
rustavi	рустави
rusya	россия
rusçuk	русе
ruta	рута
rutaceae	рутовые
ruthenia	рутения
rutil	рутил
ružomberok	ружомберок
ryan	райан
ryazan	рязань
ryder	райдер
rzeszów	жешув
réunion	реюньон
röle	реле
rönesans	возрождение
röntgen	рентген
röportaj	репортаж
rügen	рюген
rükû	руку
rüstem	рустам
rüya	сновидение
rüzgâr	ветер
rıbinsk	рыбинск
saarbrücken	саарбрюккен
saaremaa	сааремаа
saat	часы
saatçi	часовщик
saba	саба
sabadell	сабадель
sabah	утро
sabantoy	сабантуй
sabit	постоянная
sabotaj	саботаж
sabrina	сабрина
sabun	мыло
sabır	терпение
sacco	сакко
sada	сада
sadko	садко
safakes	сфакс
safer	сафар
safir	сапфир
safsızlık	примесь
saga	сага
sagamihara	сагамихара
sahalin	сахалин
sahel	сахель
sahne	сцена
sahra	сахара
saipan	сайпан
sakal	борода
sakarmeke	лысуха
sake	саке
sakigiller	саковые
saklambaç	прятки
sakrament	таинство
sakurai	сакураи
salamanca	саламанка
salamandra	саламандры
salar	салар
salas	салас
salazar	саласар
saldus	салдус
saldırganlık	агрессивность
salem	сейлем
salerno	салерно
salih	салих
salisbury	солсбери
salla	салла
salman	салман
salona	салона
salta	сальта
salto	сальто
salzburg	зальцбург
salé	сале
salı	вторник
salıncak	качели
salınım	колебания
samadhi	самадхи
saman	сено
samara	самара
samarya	самария
sambo	самбо
sambucus	бузина
sami	сами
samizdat	самиздат
samnitler	самниты
samoa	самоа
samokov	самоков
samson	самсон
samsun	самсун
samtredia	самтредиа
samtshe	самцхе
samuel	самуил
samuelson	самуэльсон
samur	соболь
samuray	самурай
sanat	искусство
sanatlar	искусства
sanatoryum	санаторий
sanayi	промышленность
sanayileşme	индустриализация
sanchi	санчи
sandalet	сандалии
sandefjord	саннефьорд
sandnes	саннес
sandomierz	сандомир
sandviken	сандвикен
sandviç	сэндвич
sandık	сундук
saniye	секунда
sanok	санок
sansar	куницы
sanskrit	санскрит
sansür	цензура
santa	санта
santander	сантандер
santimetre	сантиметр
santos	сантус
sanuki	сануки
sanık	ответчик
sapindaceae	сапиндовые
saponin	сапонины
sapporo	саппоро
sarapul	сарапул
sarasota	сарасота
saraswati	сарасвати
saratov	саратов
saravak	саравак
saray	дворец
saraybosna	сараево
sarazen	сарацины
sardis	сарды
sare	сарра
sargon	саргон
sari	сари
sarin	зарин
sark	сарк
sarkaç	маятник
sarkisyan	саргсян
sarkom	саркома
sarmatlar	сарматы
sarnı	сарны
sarnıç	цистерна
sarpsborg	сарпсборг
sarraf	брокер
sarık	тюрбан
sarılık	желтуха
sasan	сасан
sasebo	сасебо
saskatchewan	саскачеван
saskatoon	саскатун
sassuolo	сассуоло
saten	сатин
satir	сатиры
satranç	шахматы
satraplık	сатрап
satürn	сатурн
satış	продажи
saumur	сомюр
sauna	сауна
sava	сава
savan	саванна
savaş	война
savcı	прокурор
save	саве
saverne	саверн
savona	савона
savonlinna	савонлинна
saxifraga	камнеломка
sayfa	пейдж
saygı	уважение
sayram	сайрам
sayı	число
sazan	сазан
sazlık	плавни
saçılma	рассеяние
sağcılık	правые
scandale	скандале
scarabaeidae	пластинчатоусые
scharnhorst	шарнхорст
schenectady	скенектади
schillingsfürst	шиллингсфюрст
schindler	шиндлер
schleswig	шлезвиг
schmid	шмид
schmidt	шмидт
schmitt	шмитт
schwaz	швац
schwechat	швехат
schwedt	шведт
schwerin	шверин
sciurus	белка
scudo	скудо
seattle	сиэтл
sebze	овощи
sedenka	посиделки
seferberlik	мобилизация
seferîler	саффариды
sefiller	отверженные
sefirot	сфирот
segal	сегал
segeberg	зегеберг
segedin	сегед
segovia	сеговия
seinen	сэйнэн
seinäjoki	сейняйоки
seiyū	сэйю
seki	сэки
sekizgen	восьмиугольник
sekoya	секвойя
selamlaşma	приветствие
selangor	селангор
selene	селена
selfie	селфи
selim	селим
selma	сельма
selsovyet	сельсовет
selânik	салоники
selüloz	целлюлоза
semarang	семаранг
sembol	символ
sembolizm	символизм
semendire	смедерево
semey	семей
seminer	семинар
semiramis	семирамида
sempati	симпатия
semyonov	семёнов
senaki	сенаки
senarist	сценарист
senaryo	сценарий
senato	сенат
sendai	сендай
sendika	синдикат
sendrom	синдром
senecio	крестовник
senegal	сенегал
senfoni	симфония
senlis	санлис
sensei	сэнсэй
seongnam	соннам
sepet	корзина
seppuku	харакири
sepsis	сепсис
septe	сеута
septemvri	септември
sera	теплица
seramik	керамика
serap	мираж
serenat	серенада
serengeti	серенгети
sergipe	сержипи
serik	серик
serin	серин
sermaye	капитал
serotonin	серотонин
serpuhov	серпухов
serra	серра
serravalle	серравалле
sertifika	сертификат
servet	богатство
servi	кипарис
servigiller	кипарисовые
sesbilim	фонология
sesbirim	фонема
sessizlik	тишина
setagaya	сэтагая
setúbal	сетубал
seul	сеул
severodvinsk	северодвинск
seversk	северск
severstal	северсталь
sevil	севиль
sevilla	севилья
sevinç	радость
sevlievo	севлиево
sevr	севр
seyahat	путешествие
seyhun	сырдарья
seyir	навигация
seyirci	публика
seyyid	сеид
sezer	сезер
sezgi	интуиция
sezyum	цезий
seçim	выборы
seçki	антология
sfenks	сфинкс
shaggy	шэгги
shakira	шакира
sheamus	шеймус
sheerness	ширнесс
sheffield	шеффилд
shelby	шелби
sherbrooke	шербрук
sherlock	шерлок
sherry	херес
shijiazhuang	шицзячжуан
shikoku	сикоку
shinagawa	синагава
shinjuku	синдзюку
shinsengumi	синсэнгуми
shona	шона
shrewsbury	шрусбери
shropshire	шропшир
shugo	сюго
shun	шунь
shōnen	сёнэн
sibernetik	кибернетика
siberpunk	киберпанк
sibin	сибиу
sibirya	сибирь
sibylla	сивиллы
sicilya	сицилия
side	сиде
sidney	сидней
siedlce	седльце
siegen	зиген
siena	сиена
sieradz	серадз
sigmaringen	зигмаринген
sigorta	страхование
sigurd	зигфрид
siirt	сиирт
siklon	циклон
silah	оружие
silahsızlanma	разоружение
silaj	силос
silanus	силан
silene	смолёвка
silenos	силен
silezya	силезия
silindir	цилиндр
silistre	силистра
silisyum	кремний
silkeborg	силькеборг
silla	силла
silliler	инфузории
silvi	сильви
simetri	симметрия
simferopol	симферополь
simo	симо
simpsonlar	симпсоны
simya	алхимия
sinaia	синая
sinbad	синдбад
sind	синд
sindirim	пищеварение
sinek	двукрылые
sinematografi	кинематограф
singapur	сингапур
single	сингл
singspiel	зингшпиль
sinir	нерв
sinkrotron	синхротрон
sinop	синоп
sinope	синопа
sinopsis	синопсис
sintra	синтра
sinyal	сигнал
siping	сыпин
sire	сирос
sirem	срем
siren	сирены
sirenayka	киренаика
sirius	сириус
sirke	уксус
sisak	сисак
sisam	самос
sismoloji	сейсмология
sistan	систан
sistem	система
sitar	ситар
sitokin	цитокины
sitoplazma	цитоплазма
sittard	ситтард
sivas	сивас
sivasspor	сивасспор
sivastopol	севастополь
siyasetçi	политик
siyonizm	сионизм
siçuan	сычуань
siófok	шиофок
skagerrak	скагеррак
skandal	скандал
skeleton	скелетон
skellefteå	шеллефтео
skeç	скетч
skien	шиен
skleroz	склероз
skye	скай
slalom	слалом
slavlar	славяне
slavonya	славония
sliven	сливен
slogan	девиз
slonim	слоним
slough	слау
slovakya	словакия
slovenler	словенцы
slovenya	словения
smetana	сметана
smirni	смирна
smithson	смитсон
smog	смог
smolensk	смоленск
småland	смоланд
sneek	снек
snooker	снукер
sobotka	суботица
soda	сода
sodyum	натрий
sofokles	софокл
softbol	софтбол
sofya	софия
sohbet	разговор
soho	сохо
sohum	сухум
soissons	суасон
sokak	улица
soke	сокэ
soket	сокет
sokolac	соколац
sokrates	сократ
solanaceae	паслёновые
solanum	паслён
solaris	солярис
solaryum	солярий
solfej	сольфеджио
solferino	сольферино
soli	солы
solikamsk	соликамск
solin	солин
sollefteå	соллефтео
solneçnogorsk	солнечногорск
solon	солон
soluma	дыхание
somali	сомали
somaliland	сомалиленд
somalililer	сомалийцы
sombor	сомбор
somoni	сомони
sona	сона
sonat	соната
sondaj	бурение
sondershausen	зондерсхаузен
sondrio	сондрио
sone	сонет
sonneberg	зоннеберг
sonora	сонора
sonsuz	бесконечность
sonsuzluk	вечность
soprano	сопрано
sopron	шопрон
sorex	бурозубки
sorghum	сорго
sorgu	допрос
soria	сория
sorocaba	сорокаба
sorrento	сорренто
sortavala	сортавала
soru	вопрос
sorun	проблема
sosis	колбаса
sosnowiec	сосновец
sosyalizm	социализм
sosyoloji	социология
soundtrack	саундтрек
southampton	саутгемптон
sovhoz	совхоз
sovyet	совет
soyadı	фамилия
soykırım	геноцид
soyutlama	абстракция
soyuz	союз
soçi	сочи
soğuk	холод
spagetti	спагетти
spam	спам
spandau	шпандау
sparta	спарта
spartaküs	спартак
spazm	спазм
spektrometre	спектрометр
spektroskopi	спектроскопия
spektrum	спектр
speyer	шпайер
sphingidae	бражники
spike	спайк
spinacia	шпинат
spiral	спираль
spitak	спитак
spock	спок
spoiler	спойлер
spoleto	сполето
spor	спорт
spree	шпре
sprey	спрей
springfield	спрингфилд
squash	сквош
squire	оруженосец
srinagar	сринагар
stachys	чистец
stade	штаде
stadhouder	штатгальтер
stadyum	стадион
staffordshire	стаффордшир
stalag	шталаг
standardizasyon	стандартизация
standart	штандарт
stanitsa	станица
staphylinidae	стафилиниды
stargard	старгард
stark	старк
starnberg	штарнберг
starodub	стародуб
statik	статика
stavanger	ставангер
stavka	ставка
stavropol	ставрополь
steinfurt	штайнфурт
stel	стела
stenbock	стенбок
stendal	штендаль
stendhal	стендаль
stenoz	стеноз
stephen	стефан
stereotip	стереотип
sterling	стерлинг
sterlitamak	стерлитамак
stern	стерн
sterna	крачки
steroid	стероиды
stiks	стикс
stil	стиль
stilistlik	стилист
sting	стинг
stiren	стирол
stockholm	стокгольм
stout	стаут
strabon	страбон
stralsund	штральзунд
stratford	стратфорд
stratigrafi	стратиграфия
stratovolkan	стратовулкан
straubing	штраубинг
strauss	штраус
strazburg	страсбург
stres	стресс
striptiz	стриптиз
stronsiyum	стронций
struga	струга
sturnus	скворцы
stuttgart	штутгарт
subay	офицер
subbotnik	субботник
suca	суджа
suceava	сучава
sudan	судан
suevi	свевы
suffolk	суффолк
suharto	сухарто
suhl	зуль
suihua	суйхуа
sukarno	сукарно
sula	олуши
sulak	сулак
sulama	орошение
sulawesi	сулавеси
sultan	султан
suluboya	акварель
sumak	сумах
sumatra	суматра
sumbawa	сумбава
sumida	сумида
sumo	сумо
sunderland	сандерленд
sundsvall	сундсвалль
sundurma	крыльцо
sunset	сансет
superettan	суперэттан
superman	супермен
surabaya	сурабая
suraj	сураж
surgut	сургут
surinam	суринам
suriye	сирия
surrey	суррей
surtr	сурт
surya	сурья
susamak	жажда
susanoo	сусаноо
susitna	суситна
sussex	суссекс
sutra	сутра
suva	сува
suwałki	сувалки
suwon	сувон
suzdal	суздаль
suzhou	сучжоу
suşi	суши
svahili	суахили
svalbard	шпицберген
svaneti	сванетия
svastika	свастика
svilengrad	свиленград
swansea	суонси
swindon	суиндон
swing	свинг
sylvia	сильвия
synthesizer	синтезатор
szabó	сабо
szentendre	сентендре
szlachta	шляхта
szombathely	сомбатхей
sándor	шандор
sávio	савио
ségou	сегу
södertälje	сёдертелье
sölom	целом
sörf	сёрфинг
söylev	дискурс
sözdizim	синтаксис
sözleşme	договор
sözlük	словарь
sözlükbilim	лексикография
sørensen	сёренсен
sühreverdi	сухраварди
süleyman	соломон
süleymaniye	сулеймания
sülfat	сульфаты
sülük	пиявки
sümbül	гиацинт
sümük	слизь
süngü	штык
sünnilik	сунниты
süpergrup	супергруппа
süperiletkenlik	сверхпроводимость
süperkıta	суперконтинент
süpermarket	супермаркет
süpürge	метла
sürgündekiler	изгнанники
süryaniler	ассирийцы
sürü	стадо
süvari	кавалерия
süyümbike	сююмбике
sıcaklık	температура
sıkıntı	скука
sınıflama	классификация
sırbistan	сербия
sırplar	сербы
sırt	спина
sıtma	малярия
sıvı	жидкость
sızran	сызрань
sığınak	бункер
sōka	сока
tabanca	пистолет
tabasco	табаско
taberistan	табаристан
tabla	табла
tabloid	таблоид
tabu	табу
tabur	батальон
tabut	гроб
tabya	редут
tachikawa	татикава
tacikistan	таджикистан
tacikler	таджики
tacir	купец
tacoma	такома
tafta	тафта
taganrog	таганрог
tahir	тахир
tahiti	таити
tahran	тегеран
tahta	древесина
tahvil	облигация
taika	тайка
taipei	тайбэй
taiyuan	тайюань
taiz	таиз
taizhou	тайчжоу
takamatsu	такамацу
takas	обмен
takasaki	такасаки
taksi	такси
taksir	халатность
takson	таксон
taksonomi	таксономия
taku	таку
takvim	календарь
takımada	архипелаг
takımyıldız	созвездие
taliban	талибан
talin	талин
talk	тальк
tallinn	таллин
talmud	талмуд
tamale	тамале
tamaulipas	тамаулипас
tamba	тамба
tambov	тамбов
tamiller	тамилы
tampa	тампа
tampere	тампере
tampico	тампико
tanana	танана
tanca	танжер
tango	танго
tangshan	таншань
tank	танк
tanka	танка
tanker	танкер
tankette	танкетка
tantra	тантра
tanzanya	танзания
tanımlık	артикль
tarantella	тарантелла
taranto	таранто
taraz	тараз
tarbes	тарб
tarhan	тархан
tarifa	тарифа
tarih	история
tarihyazımı	историография
tarihçi	историк
tarikat	тарикат
tarja	тарья
tarnobrzeg	тарнобжег
tarnów	тарнув
tarquinia	тарквиния
tarragona	таррагона
tart	тарт
tartu	тарту
tarzan	тарзан
tasarruf	сбережения
tasarım	дизайн
tasarımcı	дизайнер
tasavvuf	суфизм
taslak	черновик
tasman	тасман
tataristan	татарстан
tatarlar	татары
tatil	отпуск
tatlar	таты
tatneft	татнефть
tauragė	таураге
taurasi	таурази
tava	сковорода
tavan	потолок
taverna	таверна
tavuk	курица
tavukçuluk	птицеводство
tayfun	тайфун
tayga	тайга
taylar	тайцы
taza	таза
tazmanya	тасмания
taşikardi	тахикардия
taşkent	ташкент
taşlıca	плевля
taşoz	тасос
tczew	тчев
tebessüm	улыбка
tebriz	тебриз
tecavüz	изнасилование
tefekkür	мышление
tefsir	тафсир
tegernsee	тегернзе
tegin	тегин
tegucigalpa	тегусигальпа
tehcir	депортация
tekboynuz	единорог
tekel	монополия
tekerlek	колесо
tekila	текила
tekke	ханака
teknisyen	техник
teknoloji	технология
teksas	техас
tekstil	текстиль
tekvando	тхэквондо
telaffuz	произношение
telavi	телави
tele	теле
telefon	телефон
telekomünikasyon	электросвязь
telemark	телемарк
telenovela	теленовелла
teleskop	телескоп
televizyon	телевидение
teltow	тельтов
teluguca	телугу
telšiai	тельшяй
tema	тема
temel	фундамент
temeşvar	тимишоара
temirtau	темиртау
temmuz	июль
tempera	темпера
temyiz	апелляция
tendai	тэндай
tendon	сухожилие
teneke	жесть
tenerife	тенерифе
tengri	тенгри
tenis	теннис
tennessee	теннесси
tenor	тенор
tenri	тэнри
tensör	тензор
teorem	теорема
teori	теория
teos	теос
tepe	холм
teplice	теплице
terah	фарра
teramo	терамо
teraryum	террариум
terazi	весы
terceira	терсейра
terengganu	тренгану
teresina	терезина
terim	термин
teriyer	терьеры
terminal	терминал
termit	термиты
termodinamik	термодинамика
termometre	термометр
terni	терни
ternopil	тернополь
tersane	верфь
tertullianus	тертуллиан
teruel	теруэль
terzi	портной
terörizm	терроризм
tesla	тесла
teslis	троица
tespih	чётки
test	тест
testis	семенники
testosteron	тестостерон
teteven	тетевен
tethys	тетис
teti	тети
tevrat	тора
texcoco	тескоко
teyp	магнитофон
teğmen	лейтенант
thale	тале
thaler	талер
thema	фема
themis	фемида
themistokles	фемистокл
theofano	феофано
theravada	тхеравада
thimphu	тхимпху
thionville	тьонвиль
thurgau	тургау
thüringen	тюрингия
tianshui	тяньшуй
tiara	тиара
tiber	тибр
tiberius	тиберий
tibetliler	тибетцы
ticaret	торговля
tientsin	тяньцзинь
tiergarten	тиргартен
tiflis	тбилиси
tihvin	тихвин
tijuana	тихуана
tikal	тикаль
tiksi	тикси
tilburg	тилбург
tilki	лисица
timbaland	тимбалэнд
timbuktu	томбукту
timiș	тимиш
timor	тимор
timoşenko	тимошенко
timpani	литавры
timsahlar	крокодилы
timur	тамерлан
tintoretto	тинторетто
tipografi	типографика
tiraj	тираж
tiran	тиран
tiraspol	тирасполь
tirmiz	термез
tisa	тиса
titan	титаны
titian	тициан
titreşim	вибрация
tivoli	тиволи
tiwanaku	тиуанако
tiyatro	театр
tizpon	ктесифон
tişört	футболка
tkibuli	ткибули
tkvarçeli	ткварчели
tlaxcala	тласкала
tobago	тобаго
tocantins	токантинс
tockus	токо
tofu	тофу
toga	тога
togo	того
tohum	семя
tokchon	токчхон
tokelau	токелау
tokmak	токмак
toksikoloji	токсикология
toksin	токсин
tokyo	токио
tolentino	толентино
toluen	толуол
tolyatti	тольятти
tomar	томар
tommy	томми
tomografi	томография
tomsk	томск
tonami	тонами
tondela	тондела
tondo	тондо
tonga	тонга
tonghua	тунхуа
tonoz	свод
topaz	топаз
toplama	сложение
topluluk	сообщество
toplum	общество
toplumsallaşma	социализация
topola	топола
topoloji	топология
toponimi	топонимика
topoğrafya	топография
toprak	почва
torf	торф
torgau	торгау
torino	турин
torjok	торжок
tornio	торнио
toronto	торонто
toropets	торопец
torpido	торпеда
torres	торрес
torun	внуки
toruń	торунь
toryum	торий
toskana	тоскана
tosno	тосно
tosu	тосу
totila	тотила
toulon	тулон
toulouse	тулуза
tourcoing	туркуэн
tovuz	товуз
toynaklılar	копытные
tozlaşma	опыление
trablus	триполи
trabzan	перила
trabzon	трабзон
track	трек
trafford	траффорд
trajan	траян
trajedi	трагедия
trakai	тракай
traklar	фракийцы
traktör	трактор
trakya	фракия
tramvay	трамвай
trani	трани
transbaykal	забайкалье
transept	трансепт
transfer	трансфер
transformatör	трансформатор
transformers	трансформеры
transistör	транзистор
transkripsiyon	транскрипция
transliterasyon	транслитерация
trapani	трапани
traunstein	траунштайн
travelers	путешественники
travis	трэвис
travmatoloji	травматология
trelleborg	треллеборг
tremor	тремор
tren	поезд
trento	тренто
trenton	трентон
trenčín	тренчин
treviso	тревизо
treyler	прицеп
triatlon	триатлон
tribeca	трайбека
tribün	трибун
trier	трир
trieste	триест
trindade	триндади
trinity	тринити
tripsin	трипсин
triptik	триптих
triptofan	триптофан
tripura	трипура
tristana	тристана
triticum	пшеница
triton	тритон
triumvirlik	триумвират
trnava	трнава
troilos	троил
troleybüs	троллейбус
trombon	тромбон
trombositopeni	тромбоцитопения
tromboz	тромбоз
troms	тромс
tromsø	тромсё
trondheim	тронхейм
troya	троя
troyes	труа
truro	труро
trøndelag	трёнделаг
tsarevo	царево
tsetserleg	цэцэрлэг
tshinvali	цхинвал
tsunami	цунами
tsuru	цуру
tuapse	туапсе
tucker	такер
tucson	тусон
tugay	бригада
tujia	туцзя
tula	тула
tulpar	тулпар
tulsa	талса
tulça	тулча
tuna	дунай
tunca	тунджа
tungsten	вольфрам
tunik	туника
tunja	тунха
tunus	тунис
turan	туран
turek	турек
turfan	турфан
turhan	турхан
turizm	туризм
turku	турку
turpgiller	капустные
turta	пирог
tutkal	клей
tutti	тутти
tutulma	затмение
tuvalu	тувалу
tuzla	тузла
tuzluluk	солёность
tuğamiral	коммодор
tuğla	кирпич
tuşino	тушино
tver	тверь
twitter	твиттер
tychy	тыхы
tyrannosaurus	тираннозавр
táchira	тачира
tâlût	саул
tórshavn	торсхавн
töre	обычай
tübingen	тюбинген
tüketici	потребитель
tükürük	слюна
tümen	дивизия
tünel	тоннель
türbe	тюрбе
türbin	турбина
türbülans	турбулентность
türk	турк
türkistan	туркестан
türkiye	турция
türkler	турки
türkmenabat	туркменабад
türkmenistan	туркменистан
türkmenler	туркмены
tütsü	благовония
tılsım	талисман
tırhala	трикала
tırnak	ногти
tırtıl	гусеница
tōhoku	тохоку
tōno	тоно
třebíč	тршебич
třinec	тршинец
uccle	уккел
udine	удине
udmurtlar	удмурты
udmurtya	удмуртия
uffizi	уффици
ufuk	горизонт
uganda	уганда
ugliç	углич
uhlan	уланы
uhta	ухта
ukaz	указ
ukrayna	украина
uksur	луксор
ukulele	укулеле
ulahlar	влахи
ulaşım	транспорт
ulsan	ульсан
ulster	ольстер
ultras	ультрас
ultrason	ультразвук
ulysses	улисс
uman	умань
umay	умай
umman	оман
umut	надежда
universitario	университарио
unutmabeni	незабудка
upanişad	упанишады
uppland	уппланд
uppsala	уппсала
uralvagonzavod	уралвагонзавод
uray	урай
uraz	ураз
urbino	урбино
urduca	урду
uruguay	уругвай
uruk	урук
urumçi	урумчи
usedom	узедом
uskuna	шхуна
usman	усмань
uspenski	успенский
ussuriysk	уссурийск
ustaşa	усташи
ustrumca	струмица
usturlap	астролябия
utanç	стыд
utsunomiya	уцуномия
uttarakhand	уттаракханд
uusimaa	уусимаа
uvertür	увертюра
uygarlık	цивилизация
uygurlar	уйгуры
uyuşturucu	наркотик
uzaktan	издалека
uzlaşma	компромисс
uzman	эксперт
uzunluk	длина
uzès	юзес
uçak	самолёт
uçalı	учалы
uçma	полёт
uçurum	клиф
uğur	удача
vaasa	вааса
vaaz	проповедь
vadi	долина
vaduz	вадуц
vaftiz	крещение
vaftizhane	баптистерий
vagon	вагон
vaha	оазис
vahran	оран
vakum	вакуум
vakıf	фонд
valday	валдай
valdivia	вальдивия
valenciennes	валансьен
valensiya	валенсия
valiz	чемодан
valka	валка
valkür	валькирия
valladolid	вальядолид
valletta	валлетта
valmiera	валмиера
vals	вальс
valur	валюр
vampir	вампир
vana	клапан
vanadyum	ванадий
vanadzor	ванадзор
vancouver	ванкувер
vandallar	вандалы
vandallık	вандализм
vani	вани
vanilin	ванилин
vantaa	вантаа
vantilatör	вентилятор
vanuatu	вануату
vapur	пароход
varad	орадя
varanasi	варанаси
varanus	вараны
varaždin	вараждин
varegler	варяги
varese	варезе
varlık	бытие
varna	варна
varoluş	существование
varyag	варяг
varyasyon	вариация
varyete	варьете
varşova	варшава
vasiyet	завещание
vaslui	васлуй
vasto	васто
vatandaş	гражданин
vatandaşlık	гражданство
vatikan	ватикан
vatnajökull	ватнайёкюдль
vatoz	скаты
vaucluse	воклюз
vazo	ваза
vaşak	рыси
veba	чума
vecd	экстаз
veche	вече
vedra	ведра
vejle	вайле
veledrom	велотрек
velenje	веленье
veli	вели
veliaht	кронпринц
velingrad	велинград
velletri	веллетри
vence	ванс
vendée	вандея
venedik	венеция
venezuela	венесуэла
venta	вента
ventspils	вентспилс
ventura	вентура
venüs	венера
veranda	веранда
vercelli	верчелли
verdun	верден
verem	туберкулёз
vergi	налог
veri	данные
verici	радиопередатчик
verimlilik	эффективность
vermont	вермонт
vermut	вермут
verona	верона
verst	верста
vertigo	головокружение
verviers	вервье
vervins	вервен
vesoul	везуль
vespasianus	веспасиан
vestfold	вестфолл
veto	вето
vevey	веве
vezir	визирь
vibrafon	вибрафон
viburnum	калина
vicdan	совесть
vicenza	виченца
vichy	виши
vicia	горошек
video	видео
vidin	видин
vidnoye	видное
vientiane	вьентьян
vierzon	вьерзон
vietnam	вьетнам
vigo	виго
viki	вики
vikikaynak	викитека
vikingler	викинги
vikipedi	википедия
vikont	виконт
vilalba	вильяльба
vilar	вилар
villach	филлах
villarreal	вильярреаль
villavicencio	вильявисенсио
vilvoorde	вилворде
vincent	винсент
vinh	винь
vinkovci	винковци
virginia	виргиния
virgül	запятая
virovitica	вировитица
virtüöz	виртуоз
virüs	вирусы
visby	висбю
viseu	визеу
viski	виски
viskozite	вязкость
vistül	висла
vitamin	витамины
viterbo	витербо
vitray	витраж
vitrin	витрина
vitruvius	витрувий
vitsebsk	витебск
viyadük	виадук
viyana	вена
viyola	альт
viyolonsel	виолончель
vize	виза
vizigotlar	вестготы
vişnu	вишну
vladikavkaz	владикавказ
vlissingen	флиссинген
vltava	влтава
vodvil	водевиль
vogt	фогт
volan	маховик
voleybol	волейбол
volga	волга
volgodonsk	волгодонск
volgograd	волгоград
volhinya	волынь
volkanizma	вулканизм
volksdeutsche	фольксдойче
vologda	вологда
volokolamsk	волоколамск
volsk	вольск
volt	вольт
voltaire	вольтер
vorarlberg	форарльберг
vorkuta	воркута
voronej	воронеж
voskresensk	воскресенск
votka	водка
votkinsk	воткинск
voynich	войнич
voyvoda	воевода
voyvodina	воеводина
vsevolojsk	всеволожск
vudaş	водяной
vudu	вуду
vuhan	ухань
vulpes	лисицы
vyazma	вязьма
vytautas	витовт
västerås	вестерос
växjö	векшё
võru	выру
vıborg	выборг
vışhorod	вышгород
waalwijk	валвейк
wageningen	вагенинген
waka	вака
wallace	уоллес
waregem	варегем
warta	варта
warwick	уорик
warwickshire	уорикшир
watcher	наблюдающий
water	уотер
waterford	уотерфорд
waterloo	ватерлоо
watford	уотфорд
watson	уотсон
watt	ватт
wehrmacht	вермахт
weifang	вэйфан
weilburg	вайльбург
weimar	веймар
weinan	вэйнань
weinstein	вайнштейн
wellington	веллингтон
wels	вельс
wenzhou	вэньчжоу
wernigerode	вернигероде
wertheim	вертхайм
wesel	везель
weser	везер
westerlo	вестерло
westminster	вестминстер
wetzlar	вецлар
whitehall	уайтхолл
whitney	уитни
wieliczka	величка
wiesbaden	висбаден
wigan	уиган
wikimapia	викимапия
wilcox	уилкокс
wilhelmshaven	вильгельмсхафен
williams	уильямс
wilmersdorf	вильмерсдорф
wilson	уилсон
wiltshire	уилтшир
winchester	винчестер
windhoek	виндхук
winnipeg	виннипег
winston	уинстон
winterthur	винтертур
wisconsin	висконсин
wismar	висмар
wissembourg	висамбур
wisteria	глициния
witten	виттен
wittenberg	виттенберг
wojciechowski	войцеховский
wolf	вольф
wolfenbüttel	вольфенбюттель
wolfsburg	вольфсбург
wolgast	вольгаст
worcester	вустер
worms	вормс
wrexham	рексем
wright	райт
wrocław	вроцлав
wuppertal	вупперталь
wyoming	вайоминг
würzburg	вюрцбург
włocławek	влоцлавек
xiamen	сямынь
xiangyang	сянъян
xicheng	сичэн
xigazê	шигадзе
xining	синин
xinxiang	синьсян
xinyang	синьян
xinzhou	синьчжоу
xuchang	сюйчан
xuzhou	сюйчжоу
yaba	вилы
yabancı	иностранец
yabancılaşma	отчуждение
yafa	яффа
yahuda	йехуда
yahudilik	иудаизм
yahveh	яхве
yaka	воротник
yakima	якима
yakova	джяковица
yakup	иаков
yakut	рубин
yakutsk	якутск
yakuza	якудза
yakıt	топливо
yalnızlık	одиночество
yalova	ялова
yalta	ялта
yamoussoukro	ямусукро
yamuk	трапеция
yanak	щека
yanardağ	вулкан
yancheng	яньчэн
yangon	янгон
yangtze	янцзы
yangın	пожар
yankee	янки
yanma	горение
yantai	яньтай
yanık	ожог
yanılsama	иллюзия
yaoundé	яунде
yaprak	лист
yara	рана
yarasa	рукокрылые
yaratıcılık	творчество
yaroslavl	ярославль
yartsevo	ярцево
yarık	ущелье
yarımada	полуостров
yarıçap	радиус
yarış	гонки
yasak	ясак
yasemin	жасмин
yasir	ясир
yastık	подушка
yatak	кровать
yatakhane	общежитие
yatırım	инвестиции
yavşan	полынь
yayla	плато
yayık	маслобойка
yayımcı	издательство
yayın	телерадиовещание
yazar	писатель
yazıt	эпитафия
yağmur	дождь
yegoryevsk	егорьевск
yehoşafat	иосафат
yekaterinburg	екатеринбург
yele	грива
yelek	жилет
yelets	елец
yelken	парус
yellowknife	йеллоунайф
yelnya	ельня
yemen	йемен
yemin	присяга
yengeç	крабы
yenidoğan	новорождённый
yenilenme	регенерация
yenisey	енисей
yeniçeri	янычары
yeremya	иеремия
yerleşke	кампус
yetişkin	взрослый
yetkilendirme	авторизация
yevlah	евлах
yevromaydan	евромайдан
yeysk	ейск
yeşilbaş	кряква
yeşiva	иешива
yibin	ибинь
yidiş	идиш
yinchuan	иньчуань
yingkou	инкоу
yoda	йода
yoga	йога
yogyakarta	джокьякарта
yokohama	иокогама
yokosuka	йокосука
yoksulluk	бедность
yolcu	пассажир
yolsuzluk	коррупция
yoni	йони
yonne	йонна
yontu	статуя
york	йорк
yorkshire	йоркшир
yorumcu	комментатор
yorumlayıcı	интерпретатор
yorumsamacılık	герменевтика
yozgat	йозгат
yoğunlaşma	конденсация
yoğunluk	плотность
yoğurt	йогурт
ystad	истад
yuan	юань
yugoslavlar	югославы
yugoslavya	югославия
yukagirler	юкагиры
yulaf	овёс
yule	йоль
yulin	юйлинь
yumru	клубень
yumuşakçalar	моллюски
yuncheng	юньчэн
yurtseverlik	патриотизм
yutak	глотка
yutland	ютландия
yvelines	ивелин
yönetici	директор
yönlendirici	маршрутизатор
yönlendirme	маршрутизация
yörünge	орбита
yücelik	возвышенное
yüklem	сказуемое
yükseltgenme	окисление
yünnan	юньнань
yüzdelik	процент
yüzey	поверхность
yüzgeç	плавник
yılan	змеи
yıldız	звезда
yılmaz	йылмаз
yōkai	ёкай
zabrze	забже
zadar	задар
zagreb	загреб
zaibatsu	дзайбацу
zaire	заир
zakopane	закопане
zaman	время
zambak	лилия
zambezi	замбези
zambiya	замбия
zamk	камедь
zamora	самора
zamość	замосць
zanaat	ремесленник
zante	закинф
zaporijya	запорожье
zaprešić	запрешич
zara	зара
zaragoza	сарагоса
zaraysk	зарайск
zarf	конверт
zatürre	пневмония
zebra	зебры
zebur	псалтирь
zehirlenme	отравление
zehlendorf	целендорф
zeitz	цайц
zekâ	интеллект
zelenograd	зеленоград
zemfira	земфира
zemun	земун
zengezur	зангезур
zenit	зенит
zeno	дзено
zenobia	зенобия
zenta	сента
zerdüştçülük	зороастризм
zerefşan	зеравшан
zermatt	церматт
zestaponi	зестафони
zeus	зевс
zevk	удовольствие
zeytingiller	маслиновые
zhangjiakou	чжанцзякоу
zhangye	чжанъе
zhejiang	чжэцзян
zhuhai	чжухай
zibo	цзыбо
ziegler	циглер
zigot	зигота
zikzak	зигзаг
zilyetlik	владение
zimbabve	зимбабве
zincifre	киноварь
zirkon	циркон
zittau	циттау
ziyafet	банкет
ziştovi	свиштов
zlatibor	златибор
zlatoust	златоуст
zlín	злин
zodyak	зодиак
zombi	зомби
zooloji	зоология
zootekni	зоотехния
zorbalık	травля
zorro	зорро
zrenjanin	зренянин
zufar	дофар
zugdidi	зугдиди
zuluca	зулу
zulular	зулусы
zuma	зума
zvolen	зволен
zvornik	зворник
zwickau	цвиккау
zwolle	зволле
zürafa	жирафы
zürih	цюрих
zımba	скоба
zıpkın	гарпун
zırh	броня
águilas	агилас
árpád	арпад
ásgard	асгард
ávila	авила
âdem	адам
âdet	нравы
âmin	аминь
âşık	ашуг
ålesund	олесунн
ångström	ангстрем
çadır	палатка
çakal	шакалы
çakra	чакра
çalı	кустарник
çamgiller	сосновые
çamlık	чамлык
çampa	тямпа
çamur	грязь
çanakkale	чанаккале
çangçun	чанчунь
çanta	сумка
çareviç	царевич
çarpma	умножение
çarpıştırıcı	коллайдер
çarşak	осыпь
çarşı	базар
çatı	крыша
çavdar	рожь
çavuş	сержант
çaygiller	чайные
çaylak	коршуны
çeburaşka	чебурашка
çehrin	чигирин
çekiç	молоток
çekler	чехи
çekoslovakya	чехословакия
çelenk	венок
çelik	сталь
çelişki	противоречие
çelyabinsk	челябинск
çember	окружность
çene	челюсть
çeng	ченг
çengdu	чэнду
çerepovets	череповец
çerez	печенье
çerkası	черкассы
çerkessk	черкесск
çerkesya	черкесия
çernezyom	чернозёмы
çernihiv	чернигов
çernivtsi	черновцы
çernobil	чернобыль
çetin	четин
çetine	цетине
çetnikler	четники
çeviri	перевод
çevirmen	переводчик
çeyiz	приданое
çeçenler	чеченцы
çeşme	фонтан
çiftleşme	спаривание
çiftlik	ферма
çiftçi	фермер
çikolata	шоколад
çilek	земляника
çimen	газон
çimento	цемент
çimkent	шымкент
çine	чине
çinghay	цинхай
çinko	цинк
çinliler	китайцы
çirmişler	марийцы
çita	гепард
çivi	гвоздь
çizgi	тире
çizim	рисунок
çiçek	цветок
çiğdem	шафран
çoban	пастух
çocuk	ребёнок
çokgen	многоугольник
çolak	чолак
çongçing	чунцин
çorap	носки
çoruh	чорох
çoğunluk	большинство
çubu	тюбу
çuvaşistan	чувашия
çuvaşlar	чуваши
çömlek	горшок
çözelti	раствор
çöçek	чугучак
çıkarma	вычитание
çıkış	исход
çınar	платан
écija	эсиха
épinal	эпиналь
étampes	этамп
évora	эвора
évreux	эврё
ödem	отёк
ödül	награда
öfori	эйфория
öksürük	кашель
öland	эланд
ölçme	измерение
ölüm	смерть
ölümsüzlük	бессмертие
önbölüm	приквел
önlük	фартук
önsöz	предисловие
öpücük	поцелуй
ördek	утки
örebro	эребру
örümcek	пауки
örüntü	паттерн
östersund	эстерсунд
ötegezegen	экзопланета
öykünücü	эмуляция
özbekistan	узбекистан
özbekler	узбеки
özdeyiş	афоризм
özelleştirme	приватизация
özerklik	автономия
özgeçmiş	резюме
özgürlük	свобода
özne	подлежащее
öğle	полдень
öğrenci	учащийся
öğretmen	учитель
øresund	эресунн
østfold	эстфолл
ültimatom	ультиматум
ümmet	умма
üniforma	униформа
üniversite	университет
ünsüz	согласные
ürdün	иордания
üreme	размножение
üretim	производство
ürgenç	ургенч
ürtiker	крапивница
ürün	продукт
üsküp	скопье
üstdev	сверхгигант
üstsüzlük	топлес
üstündev	гипергигант
ütopya	утопия
üzengi	стремя
üzüntü	грусть
üçgen	треугольник
üçleme	трилогия
čáslav	часлав
đakovo	джяково
đồng	донг
iason	ясон
ibadet	богослужение
ibiza	ивиса
ibrahim	авраам
icevan	иджеван
idarecilik	менеджмент
iddianame	обвинение
idealizm	идеализм
ideoloji	идеология
idlib	идлиб
idol	идол
idris	идрис
ifrikiye	ифрикия
iftira	клевета
igarka	игарка
iglo	иглу
ihracat	экспорт
ihtiman	ихтиман
ijevsk	ижевск
ikarus	икар
ikarya	икария
ikilem	дилемма
ikiyüzlülük	лицемерие
iklim	климат
ikona	икона
iksir	зелье
iktidar	власть
ilahi	гимн
ilahiyat	богословие
ilam	илам
iletişim	общение
iletken	кондуктор
ilhak	аннексия
ilhan	ильхан
ilirya	иллирия
illüstrasyon	иллюстрация
ilyada	илиада
ilyas	илия
imago	имаго
imam	имам
imamet	имамат
imereti	имеретия
imişli	имишли
imlâ	правописание
immünoloji	иммунология
imparator	император
implant	имплантаты
imza	подпись
inci	жемчуг
incil	евангелие
incir	инжир
indie	инди
indigirka	индигирка
indirgenme	редукция
indiyum	индий
indol	индол
indüktans	индуктивность
ingilizler	англичане
ingiltere	англия
inguşetya	ингушетия
inguşlar	ингуши
inisiyasyon	инициация
inme	инсульт
inovasyon	инновация
insan	человек
insidans	заболеваемость
insomnia	бессонница
insülin	инсулин
inta	инта
integral	интеграл
internet	интернет
internod	стебель
interpolasyon	интерполяция
intihal	плагиат
intihar	самоубийство
intikam	месть
inşaat	строительство
iota	йота
iphigenia	ифигения
iplik	пряжа
ipsara	псара
iran	иран
iranlılar	иранцы
irin	гной
irkutsk	иркутск
irlanda	ирландия
irlandalılar	ирландцы
ironi	ирония
isfahan	исфахан
ishak	исаак
ishal	диарея
isis	исида
iskandinavya	скандинавия
iskelet	скелет
iskenderiye	александрия
iskeçe	ксанти
iskitya	скифия
iskoçlar	шотландцы
iskoçya	шотландия
islam	ислам
islamabad	исламабад
islamlaşma	исламизация
ismailiye	исмаилия
ispanya	испания
israfil	исрафил
israil	израиль
israilliler	израильтяне
istanbul	стамбул
istasyon	станция
istatistik	статистика
istihbarat	разведка
istila	вторжение
istirya	истрия
isveç	швеция
isviçre	швейцария
isviçreliler	швейцарцы
italya	италия
italyanlar	итальянцы
ithalat	импорт
itimat	уверенность
ivaylo	ивайло
ivme	ускорение
ivmeölçer	акселерометр
iyimserlik	оптимизм
iyonlaşma	ионизация
izabe	плавка
izberbaş	избербаш
izlanda	исландия
izlandalılar	исландцы
izlenimcilik	импрессионизм
izmail	измаил
izmir	измир
izomer	изомер
izomorfizma	изоморфизм
izotop	изотопы
izvestiya	известия
içecek	напиток
içerik	содержание
içgüdü	инстинкт
iğrenme	отвращение
işaya	исаия
işbirlikçilik	коллаборационизм
işgal	оккупация
işim	ишим
işitme	слух
işkence	пытка
işkodra	шкодер
işleme	рендеринг
işletme	бизнес
işsizlik	безработица
iştar	иштар
iştip	штип
işveren	работодатель
işçi	работник
łomża	ломжа
łowicz	лович
łódź	лодзь
świdnica	свидница
świecie	свеце
świnoujście	свиноуйсьце
şaban	шабан
şabat	шаббат
şafak	рассвет
şahe	шахе
şaheser	шедевр
şahruh	шахрух
şahtı	шахты
şair	поэт
şakak	висок
şalmanezer	салманасар
şalvar	шаровары
şamahı	шемахы
şaman	шаман
şamanizm	шаманизм
şampanya	шампанское
şanghay	шанхай
şanlıurfa	шанлыурфа
şanson	шансон
şansölye	канцлер
şantaj	шантаж
şantung	шаньдун
şanyu	шаньюй
şapka	шляпа
şarap	вино
şarapçılık	виноделие
şarkı	песня
şarkıcı	певец
şato	шато
şaşkınlık	удивление
şehir	город
şehit	мученик
şehnâme	шахнаме
şeker	сахар
şeki	шеки
şelale	водопад
şemkir	шамкир
şengavit	шенгавит
şensi	шэньси
şeriat	шариат
şevçenko	шевченко
şeyh	шейх
şeytan	сатана
şian	сиань
şiban	шибан
şiddet	насилие
şiilik	шииты
şikâyet	жалоба
şili	чили
şimonoseki	симоносеки
şimşir	самшит
şiraz	шираз
şirket	фирма
şiva	шива
şizofreni	шизофрения
şişe	бутылка
şogi	сёги
şogun	сёгун
şorlar	шорцы
şort	шорты
şose	шоссе
şovmen	шоумен
şubat	февраль
şumnu	шумен
şurup	сироп
şuşa	шуша
şömine	камин
şövalye	рыцарь
şövalyelik	рыцарство
şüphe	сомнение
şırınga	шприц
šabac	шабац
šiauliai	шяуляй
šibenik	шибеник
šilutė	шилуте
żagań	жагань
žilina	жилина
